Pronoun-offset,A-offset,B-offset,offsetPronoun-A,offsetPronoun-B,pre_predict-A,pre_predict-B,pre_predict-N,tar_predict-A,tar_predict-B,tar_predict-N,PronounType,GenderBin,CountNounA,CountNounB,Pronoun_binary,IsFinalPro,IsInitialPro
383,352,366,-31,-17,0.336680886248736,0.5280364919317099,0.13528262181955442,0.4020450775965,0.4872103431316379,0.11074457927186179,1,0,1,2,2,1,0
430,353,390,-77,-40,0.4036082217617564,0.4894906454199238,0.10690113281831966,0.3979203171087502,0.4919735130397109,0.11010616985153901,1,0,2,1,3,1,0
312,256,295,-56,-17,0.36609615967378284,0.5062495671447893,0.12765427318142752,0.46811334808133687,0.4182891384736841,0.1135975134449789,0,0,2,1,0,1,0
526,377,536,-149,10,0.41115373478989264,0.47508623670119576,0.11376002850891168,0.3415681636887241,0.5466489582898976,0.11178287802137794,1,0,3,2,2,0,0
406,421,559,15,153,0.4757919679937506,0.3922866047680672,0.1319214272381821,0.4829469871960558,0.40095660682757767,0.11609640597636607,1,0,2,1,2,0,1
349,281,310,-68,-39,0.44111037899005934,0.3828305940273483,0.17605902698259235,0.5115447740180766,0.3694535862396678,0.11900163974225568,1,1,1,2,4,1,0
365,232,290,-133,-75,0.40209341164178203,0.4649138564677265,0.13299273189049196,0.5415275124192563,0.3433730676110013,0.11509941996974227,0,1,3,1,1,1,0
307,248,277,-59,-30,0.3642675121760815,0.5142568964793077,0.12147559134461088,0.3779992693722811,0.5103958525980523,0.11160487802966639,1,1,1,2,4,1,0
227,124,169,-103,-58,0.48749536830870555,0.41373504499178515,0.09876958669950943,0.5407357929888634,0.34371867085429914,0.11554553615683746,0,0,2,1,0,1,0
223,78,154,-145,-69,0.40557495895870316,0.46651891500814613,0.1279061260331505,0.40740208584289683,0.4808354836785529,0.11176243047855051,1,1,1,2,4,1,0
344,313,369,-31,25,0.5017534690702896,0.4035375277831764,0.09470900314653394,0.4591413124364722,0.4284255001862606,0.11243318737726747,1,1,1,1,4,0,0
290,195,207,-95,-83,0.3804501877111965,0.48302421154078345,0.13652560074802006,0.39973570190613766,0.4851971324776302,0.11506716561623219,0,1,1,1,1,1,0
352,206,232,-146,-120,0.4461822990600249,0.44771662391674866,0.10610107702322644,0.4220475662594263,0.46646494068530087,0.11148749305527271,1,0,2,2,2,1,0
256,181,222,-75,-34,0.44145094796985335,0.44926618622100517,0.10928286580914122,0.42811450806987705,0.459743154134037,0.11214233779608587,0,0,1,2,0,1,0
126,0,70,-126,-56,0.4889771096265324,0.41089288490555803,0.10013000546790946,0.48218455228303453,0.4027461069001812,0.11506934081678413,0,1,1,1,1,1,0
320,360,445,40,125,0.35878658836273397,0.5146504004933704,0.1265630111438958,0.5134056263185619,0.37081295372014167,0.11578141996129623,1,0,4,2,2,0,1
302,185,282,-117,-20,0.46894602662611473,0.4048729519882114,0.12618102138567378,0.5437834919974267,0.3441571122897073,0.112059395712866,0,1,1,1,1,1,0
297,165,228,-132,-69,0.3955479925041181,0.49791742742812556,0.10653458006775635,0.43167659883076154,0.457126508684215,0.11119689248502358,1,1,2,1,4,1,0
277,210,241,-67,-36,0.40121621152794457,0.47716983194886464,0.12161395652319051,0.5081443887037248,0.38111677421359663,0.1107388370826785,1,1,2,1,4,1,0
182,0,248,-182,66,0.5418313169713297,0.3521387877055512,0.10602989532311873,0.48821918456409447,0.3925531306337452,0.11922768480216014,0,0,1,2,0,0,0
349,298,314,-51,-35,0.2871200331485346,0.5847541109908564,0.1281258558606091,0.3719313127203052,0.5173135492238666,0.11075513805582808,1,0,3,3,2,1,0
313,242,272,-71,-41,0.3536173906406201,0.5426954775759054,0.1036871317834748,0.46336887650427555,0.4221926637111884,0.11443845978453607,1,1,1,2,4,1,0
270,173,231,-97,-39,0.53383271436714,0.3555358215625938,0.11063146407026624,0.46856630449743486,0.41724436399538195,0.11418933150718324,0,0,2,1,0,1,0
509,294,495,-215,-14,0.2783964463487059,0.5900177998175001,0.1315857538337938,0.5433751909144082,0.34216900675051026,0.11445580233508154,0,0,2,1,0,1,0
394,299,361,-95,-33,0.43692625946088687,0.43438052163888907,0.12869321890022417,0.482685419065652,0.4063565695031028,0.11095801143124519,1,0,1,1,2,1,0
314,253,325,-61,11,0.41319630193364354,0.4648533335326524,0.12195036453370378,0.4132109018263184,0.4749006582677823,0.11188843990589882,1,0,1,1,2,0,0
43,0,28,-43,-15,0.5046185379764574,0.38497618019578195,0.1104052818277609,0.4447960869387069,0.44200887108444425,0.11319504197684871,1,1,1,1,4,1,0
244,260,312,16,68,0.4717479922823644,0.4148486074101333,0.11340340030750184,0.5101172858535563,0.3787309008068989,0.11115181333954473,1,1,1,3,4,0,1
267,208,231,-59,-36,0.28982664164164335,0.5908288477480649,0.1193445106102918,0.4759849185748867,0.4060399767838598,0.11797510464125345,0,1,1,1,1,1,0
290,212,301,-78,11,0.3922143268390153,0.4837776087445883,0.12400806441639653,0.44777548516208854,0.4357688963968798,0.11645561844103185,1,0,1,1,2,0,0
476,288,311,-188,-165,0.3832867353821395,0.5073996013401567,0.10931366327770398,0.3563300297037564,0.5325099432653521,0.11116002703089144,0,0,1,2,0,1,0
322,246,307,-76,-15,0.3647093137205274,0.5096513217471207,0.1256393645323519,0.49480239912613017,0.38984722972197705,0.115350371151893,1,0,1,2,2,1,0
340,307,322,-33,-18,0.2755755890644843,0.6048524579189032,0.11957195301661222,0.4247700680498878,0.4686799209424554,0.10655001100765693,1,0,2,2,2,1,0
296,329,397,33,101,0.4248938450823642,0.4738658051692044,0.1012403497484316,0.497702254009724,0.3920354617789848,0.1102622842112913,0,1,5,1,1,0,1
293,237,251,-56,-42,0.3728587022420939,0.5181114440959751,0.10902985366193084,0.4135732337926602,0.47693693997185843,0.10948982623548152,1,1,3,2,4,1,0
278,223,268,-55,-10,0.46165234075346795,0.43786472724222864,0.10048293200430324,0.4659011826499578,0.4210158150536692,0.11308300229637346,1,1,1,1,4,1,0
291,112,142,-179,-149,0.36080951023168956,0.5139407311501855,0.12524975861812487,0.3993093032821168,0.49000835283504773,0.11068234388283545,0,0,1,1,0,1,0
295,101,159,-194,-136,0.5046185379764574,0.38497618019578195,0.1104052818277609,0.4447960869387069,0.44200887108444425,0.11319504197684871,1,0,1,1,2,1,0
549,473,513,-76,-36,0.272312152164121,0.6032175006715644,0.12447034716431486,0.4140083734239149,0.47462247251627343,0.11136915405981164,1,0,1,1,2,1,0
216,152,193,-64,-23,0.5840929730095538,0.3165284650142688,0.09937856197617731,0.47594623828706545,0.41110289658356003,0.1129508651293745,0,0,2,1,0,1,0
228,245,252,17,24,0.40064467064446985,0.5073689024327586,0.09198642692277174,0.37064163155853724,0.5179116698723834,0.11144669856907931,1,0,1,2,2,0,1
530,573,621,43,91,0.38271370979432345,0.48305763205632424,0.1342286581493521,0.4806106400549492,0.3796525135253961,0.1397368464196546,1,0,1,1,2,0,1
232,174,209,-58,-23,0.5582966602510978,0.3200836414303938,0.12161969831850843,0.4763916872749654,0.410656293025398,0.11295201969963665,0,0,2,2,0,1,0
484,362,430,-122,-54,0.5136600854537481,0.3949999514716102,0.09133996307464141,0.4299178277657044,0.4581698481244972,0.11191232410979841,1,1,1,4,4,1,0
225,178,214,-47,-11,0.44176017037776044,0.4322970595264018,0.12594277009583765,0.4191269591582465,0.4681548782009734,0.11271816264078004,1,0,1,2,2,1,0
333,231,244,-102,-89,0.42714623807663754,0.45377389907948223,0.11907986284388022,0.4751774868681579,0.40846763342839815,0.11635487970344376,1,0,2,1,3,1,0
341,228,287,-113,-54,0.28091357268118194,0.6025087529841157,0.11657767433470237,0.42750884767519537,0.4621387297924633,0.11035242253234125,0,0,1,1,0,1,0
272,11,152,-261,-120,0.46954379652579226,0.4167385477782135,0.11371765569599437,0.5204753271310592,0.3621937986856438,0.11733087418329692,0,1,2,1,1,1,0
253,159,198,-94,-55,0.44744654391760114,0.4423579357493258,0.11019552033307266,0.38378687652066107,0.5036326373174852,0.11258048616185369,0,1,2,2,1,1,0
432,253,358,-179,-74,0.3399075371194673,0.4647382415935719,0.1953542212869606,0.5700148272634286,0.2864977669187256,0.14348740581784616,1,1,3,1,4,1,0
334,81,164,-253,-170,0.5046185379764574,0.38497618019578195,0.1104052818277609,0.4447960869387069,0.44200887108444425,0.11319504197684871,1,1,1,2,4,1,0
354,217,301,-137,-53,0.4936027078420011,0.4044725361669659,0.10192475599103276,0.44406060369086664,0.44492649420666963,0.11101290210246374,1,1,3,1,4,1,0
416,379,439,-37,23,0.20561528317632327,0.6608065757168002,0.13357814110687674,0.4202089555372997,0.46977740341036306,0.11001364105233734,1,0,1,1,2,0,0
142,173,403,31,261,0.4060504452900608,0.4920248515781166,0.10192470313182277,0.43097784450562665,0.457313467618471,0.1117086878759024,0,1,1,1,1,0,1
292,191,279,-101,-13,0.4371412140423751,0.39910728353013536,0.16375150242748965,0.4789405509522393,0.40222138797148205,0.1188380610762786,0,0,1,2,0,1,0
377,201,355,-176,-22,0.5046185379764574,0.38497618019578195,0.1104052818277609,0.4447960869387069,0.44200887108444425,0.11319504197684871,0,1,1,1,1,1,0
344,294,307,-50,-37,0.3012222016938133,0.5744426264754613,0.12433517183072557,0.43005085385533615,0.45603661747522245,0.11391252866944157,1,1,1,1,4,1,0
238,162,226,-76,-12,0.376199385064942,0.5163157320208484,0.1074848829142099,0.4033729327361787,0.4835281062610426,0.11309896100277896,1,0,2,2,2,1,0
317,287,300,-30,-17,0.5010945475304112,0.3912762986507936,0.10762915381879508,0.48473694357125374,0.403030720706841,0.11223233572190527,0,1,2,1,1,1,0
415,331,398,-84,-17,0.40944265219330106,0.48359668131722494,0.10696066648947411,0.5244924379472495,0.35545995451746154,0.12004760753528886,0,0,1,3,0,1,0
448,304,462,-144,14,0.5249937486499947,0.37029864020745384,0.10470761114255125,0.5216992775187023,0.3649435962840842,0.11335712619721358,1,0,2,1,2,0,0
225,0,111,-225,-114,0.46977705109550294,0.4058748361830261,0.12434811272147087,0.4983631422697371,0.3887991551390564,0.11283770259120653,0,0,1,1,0,1,0
390,216,241,-174,-149,0.42898763140558266,0.46270612853218895,0.10830624006222846,0.52630283634876,0.3625598563479783,0.11113730730326173,0,1,2,1,1,1,0
325,182,293,-143,-32,0.5480324640086509,0.33138437652917874,0.12058315946217046,0.477122757162958,0.4128313977560565,0.1100458450809852,1,0,1,1,3,1,0
73,0,208,-73,135,0.46237903814868303,0.43025660785181696,0.10736435399949985,0.4608415581344612,0.42615306622380744,0.11300537564173109,0,0,1,1,0,0,0
289,208,266,-81,-23,0.42800263141521167,0.45016876450645893,0.12182860407832892,0.46033029267694836,0.42759691953368034,0.11207278778937145,1,0,1,1,3,1,0
234,200,216,-34,-18,0.5227692729244766,0.3700354444754814,0.10719528260004216,0.45366176612290765,0.434541344786714,0.11179688909037837,0,0,1,2,0,1,0
372,246,321,-126,-51,0.46572999359712813,0.4378728359565076,0.09639717044636399,0.4008792254774158,0.48655233722310925,0.11256843729947454,1,1,2,1,4,1,0
347,220,302,-127,-45,0.39087597939117563,0.4983545435617949,0.11076947704702944,0.5450766739039301,0.33884787690579565,0.11607544919027409,0,0,1,1,0,1,0
164,120,184,-44,20,0.35151984968712674,0.5276246780953037,0.12085547221756962,0.4342662694428413,0.45488902878222875,0.11084470177493005,1,0,1,2,2,0,0
304,369,401,65,97,0.49703453826460414,0.40391844824431744,0.09904701349107821,0.5278609223206727,0.3535701024464269,0.11856897523290057,1,0,2,1,2,0,1
285,471,486,186,201,0.43867880794910324,0.44379524554642275,0.11752594650447432,0.47128695305744084,0.4067868452586412,0.12192620168391759,0,1,1,1,1,0,1
455,470,489,15,34,0.3914864528654605,0.4981067303026861,0.11040681683185323,0.5306426855612341,0.35635618706299266,0.11300112737577314,0,1,5,4,1,0,1
403,293,341,-110,-62,0.29091742002447896,0.5837254558660445,0.1253571241094766,0.5453937984167985,0.33964389132182055,0.11496231026138122,0,0,3,1,0,1,0
519,357,449,-162,-70,0.36500599258832006,0.5028857314406866,0.1321082759709934,0.43200896912884806,0.4578034088947754,0.11018762197637635,0,1,1,2,1,1,0
227,135,251,-92,24,0.526560295629691,0.36039301849825034,0.11304668587205849,0.47564437222841915,0.4136185784745502,0.11073704929703083,1,0,1,1,2,0,0
154,0,108,-154,-46,0.4795945198754979,0.41215719306083465,0.10824828706366761,0.46739526192941505,0.4189422277021317,0.11366251036845307,0,1,1,1,1,1,0
315,371,425,56,110,0.5035731676308228,0.38377317680020473,0.11265365556897257,0.4765800145691314,0.40961389069642606,0.11380609473444252,1,0,2,1,2,0,1
291,219,239,-72,-52,0.4863907998171809,0.39002270213335694,0.12358649804946213,0.45493112258968865,0.4341657068614807,0.11090317054883042,1,0,2,2,2,1,0
363,240,339,-123,-24,0.3544461560478685,0.5230254370222366,0.12252840692989486,0.3920239700318453,0.49905645073412963,0.1089195792340249,1,1,1,2,4,1,0
284,228,266,-56,-18,0.38098270348996893,0.5126648046301755,0.10635249187985585,0.47962681904273385,0.40687097915617193,0.11350220180109424,1,1,4,5,4,1,0
334,237,268,-97,-66,0.4186505578041134,0.4701487085326172,0.11120073366326944,0.4525230755398807,0.4362800504638932,0.11119687399622603,1,0,1,3,2,1,0
321,281,349,-40,28,0.4040065845632274,0.4779280497074065,0.11806536572936618,0.45437143262674007,0.4221456614183863,0.12348290595487368,0,1,1,4,1,0,0
271,198,360,-73,89,0.4892953852607058,0.39663925651228604,0.11406535822700803,0.5250736944845337,0.35978039145003554,0.11514591406543062,0,0,1,1,0,0,0
437,462,516,25,79,0.3809838072044643,0.48131344816463467,0.13770274463090104,0.4880071413344642,0.39387745582309325,0.11811540284244242,1,0,1,2,2,0,1
325,246,299,-79,-26,0.3908591675552255,0.4858467831241559,0.12329404932061853,0.5030525329460749,0.3783465940644434,0.11860087298948187,0,0,2,1,0,1,0
295,365,655,70,360,0.4476868860738611,0.4428142570737248,0.10949885685241402,0.5166688138157776,0.3669587074863203,0.11637247869790238,1,1,1,1,4,0,1
296,232,252,-64,-44,0.2870583834099396,0.5939900719764615,0.11895154461359864,0.4836805059602821,0.40083445697010806,0.11548503706960986,0,0,1,1,0,1,0
276,206,234,-70,-42,0.4705648198032643,0.4196516595603333,0.10978352063640234,0.41919665181587473,0.46955725373698726,0.11124609444713818,1,0,1,1,2,1,0
390,305,407,-85,17,0.3802453530395583,0.5088734524845754,0.1108811944758664,0.481919848728236,0.4046491960768612,0.1134309551949029,1,0,4,1,2,0,0
297,250,275,-47,-22,0.5667531803261436,0.331663883731378,0.10158293594247834,0.430796904386553,0.45730745270234036,0.11189564291110668,1,0,2,2,2,1,0
349,98,260,-251,-89,0.47731732300329344,0.4128090404600354,0.10987363653667134,0.43085438457213954,0.4563481760421329,0.11279743938572771,1,0,1,1,2,1,0
369,312,345,-57,-24,0.4409054499087257,0.43479000813864455,0.12430454195262933,0.37621366520740834,0.5129523606265058,0.11083397416608526,1,0,1,1,2,1,0
354,200,304,-154,-50,0.5027131882991448,0.3845739702930719,0.11271284140778333,0.5182489326468778,0.3585106544380792,0.12324041291504303,1,0,2,1,2,1,0
282,315,355,33,73,0.28820487362268293,0.5534050364952358,0.15839008988208095,0.4839061590127209,0.4036571466799064,0.11243669430737278,1,0,3,3,2,0,1
451,263,310,-188,-141,0.5028745050613953,0.38023655094700604,0.11688894399159887,0.5137263955539655,0.37489034397023163,0.11138326047580258,1,0,1,1,2,1,0
338,91,392,-247,54,0.4657934938434927,0.42601062914276777,0.1081958770137395,0.4880132745639451,0.395500371363214,0.11648635407284127,1,0,1,1,2,0,0
301,191,279,-110,-22,0.47933427174928506,0.3968505211386514,0.12381520711206362,0.5348835375064929,0.34484100699563464,0.1202754554978726,0,1,2,1,1,1,0
385,377,441,-8,56,0.4238797970937781,0.4746879807353465,0.10143222217087554,0.4174485962146312,0.4728346772275575,0.10971672655781112,1,0,2,4,2,0,0
149,118,136,-31,-13,0.5267676474429621,0.3699626294541062,0.10326972310293187,0.45049455353927753,0.4317118792259078,0.11779356723481454,1,1,1,1,4,1,0
497,384,470,-113,-27,0.306197496571798,0.6018741597998742,0.09192834362832802,0.48361088485530207,0.40768183871207747,0.1087072764326204,1,0,1,2,2,1,0
264,201,247,-63,-17,0.5633861141476508,0.3189821154092091,0.11763177044314016,0.41912447940407266,0.46887354665011677,0.11200197394581055,1,0,1,2,2,1,0
536,377,390,-159,-146,0.24764733642377357,0.6494752640291079,0.10287739954711843,0.3158966013660502,0.5729852626489905,0.11111813598495882,1,0,2,4,2,1,0
123,0,39,-123,-84,0.4646620163836353,0.4139861534098749,0.12135183020648958,0.4791934591154718,0.4056764709646857,0.11513006991984256,0,1,1,1,1,1,0
543,293,350,-250,-193,0.36327541347479664,0.4828993458100931,0.15382524071511042,0.5444727707020641,0.3407149386053425,0.11481229069259337,1,1,1,1,4,1,0
386,306,367,-80,-19,0.40709309542650096,0.4643976460252556,0.12850925854824335,0.39851178306152896,0.48982259561255853,0.11166562132591232,1,1,2,1,4,1,0
331,283,295,-48,-36,0.49430986348014305,0.4182251513608168,0.08746498515904015,0.41791303359124427,0.45280729304302564,0.1292796733657299,0,0,3,2,0,1,0
315,257,296,-58,-19,0.40677242000224406,0.470510580486138,0.12271699951161805,0.5023405547197963,0.378836026318567,0.11882341896163676,0,1,1,1,1,1,0
310,280,300,-30,-10,0.38096126556251947,0.499843580774956,0.11919515366252433,0.4752170266723584,0.4119359159293163,0.11284705739832535,1,0,2,3,2,1,0
243,112,173,-131,-70,0.43893644544094107,0.43820644323305447,0.1228571113260043,0.40922448704788356,0.48042775729094556,0.11034775566117075,1,1,1,1,4,1,0
273,102,116,-171,-157,0.4161015357542543,0.47938862334937515,0.10450984089637058,0.40261099766505376,0.4873839713645337,0.11000503097041237,0,0,1,1,0,1,0
521,461,499,-60,-22,0.42115518768228305,0.46311121811878103,0.11573359419893586,0.4747801781715301,0.41285604876304455,0.1123637730654251,1,0,2,1,3,1,0
324,270,286,-54,-38,0.4810387261908138,0.3950533330972096,0.12390794071197661,0.5443105393315235,0.34373511783819427,0.1119543428302821,0,1,2,1,1,1,0
379,316,333,-63,-46,0.376309077964527,0.500277381220271,0.12341354081520217,0.42798610408477294,0.4653834428372413,0.10663045307798581,1,0,1,3,2,1,0
372,348,391,-24,19,0.39658058096291143,0.4820524792883218,0.12136693974876651,0.38034327165612797,0.5103038782412512,0.10935285010262089,0,0,1,2,0,0,0
428,404,438,-24,10,0.3608052358691482,0.4874713346557389,0.15172342947511308,0.49995808467380737,0.3798422213021483,0.1201996940240443,0,1,3,4,1,0,0
382,279,448,-103,66,0.5367628540771321,0.364590690461643,0.09864645546122501,0.3920115148236329,0.47223491846912036,0.13575356670724692,1,0,3,1,3,0,0
424,177,383,-247,-41,0.4481390849861262,0.41323965571101057,0.13862125930286356,0.5369554081007489,0.34359196206875736,0.11945262983049379,0,0,1,1,0,1,0
620,468,531,-152,-89,0.32518650718897407,0.5504362488765601,0.12437724393446596,0.3778349930844241,0.5122836663679174,0.10988134054765838,1,0,1,1,2,1,0
266,237,254,-29,-12,0.36012875294558666,0.5338364376689213,0.10603480938549185,0.4956565290070232,0.38858315756121903,0.11576031343175763,1,0,2,1,2,1,0
269,130,188,-139,-81,0.40055301005209465,0.46996905377034714,0.12947793617755826,0.46254903708123557,0.40967063893375194,0.12778032398501293,0,0,1,1,0,1,0
559,470,536,-89,-23,0.2476793620807736,0.6488370793840057,0.10348355853522061,0.34336337451335947,0.5445204090481378,0.11211621643850264,1,1,3,3,4,1,0
243,200,219,-43,-24,0.45103549249626057,0.4373974112045477,0.11156709629919136,0.43727022793370723,0.4351251888755005,0.12760458319079232,0,1,1,1,1,1,0
268,10,114,-258,-154,0.47343594772391956,0.41576007944638255,0.11080397282969776,0.44694172496425943,0.42652670572957074,0.12653156930616974,0,0,1,1,0,1,0
253,228,287,-25,34,0.4094838462051496,0.47498878900431385,0.11552736479053656,0.4438127513940128,0.4444851944602166,0.11170205414577042,1,0,1,2,2,0,0
291,218,279,-73,-12,0.4346886207612851,0.4718743767928372,0.09343700244587744,0.4627368478588092,0.4266096178934712,0.11065353424771948,0,0,1,1,0,1,0
336,363,383,27,47,0.34594259170184843,0.5313249491068485,0.12273245919130317,0.5327438926433432,0.3493908143032089,0.11786529305344785,1,1,1,2,4,0,1
747,481,555,-266,-192,0.25119433357065707,0.6225393719890757,0.12626629444026682,0.2975816307480802,0.591633959437878,0.11078440981404146,1,0,1,1,2,1,0
473,446,461,-27,-12,0.4117120547683139,0.45384612294371585,0.13444182228797052,0.45486688740134695,0.4095951901782954,0.13553792242035753,1,0,1,4,2,1,0
292,241,266,-51,-26,0.44800481722195634,0.418585421731401,0.1334097610466427,0.48293907434003996,0.3970940137240976,0.11996691193586234,1,1,4,1,4,1,0
248,210,231,-38,-17,0.3734869666182373,0.5093035748430388,0.11720945853872386,0.4249821656629131,0.4645185662632696,0.11049926807381692,1,0,1,2,2,1,0
228,167,183,-61,-45,0.4507566517784057,0.43165085805059583,0.11759249017099857,0.43802786957104145,0.4498133348749335,0.11215879555402491,1,0,2,2,2,1,0
338,269,316,-69,-22,0.42055704676106487,0.4763736945515259,0.10306925868740932,0.4819388739353134,0.4064605262785036,0.11160059978618292,1,0,2,4,2,1,0
303,223,280,-80,-23,0.48896098413982,0.4008849709708911,0.1101540448892886,0.3964922329921697,0.4899149599592344,0.11359280704859587,1,1,2,2,4,1,0
312,260,407,-52,95,0.3336194144430967,0.5435272253606231,0.12285336019628024,0.3483008472319296,0.5241217528779966,0.1275773998900736,0,0,1,1,0,0,0
340,307,327,-33,-13,0.5197932901612058,0.3779383215212638,0.1022683883175303,0.5258548516595816,0.36351093970393855,0.11063420863647996,0,1,1,1,1,1,0
280,165,209,-115,-71,0.3874369038810905,0.4748648554240363,0.13769824069487321,0.5283842221870255,0.3545029728470579,0.11711280496591658,1,0,1,1,3,1,0
288,188,280,-100,-8,0.4335581326127392,0.43991908504386834,0.12652278234339234,0.45395830546823257,0.4333782222134085,0.11266347231835883,1,1,1,2,4,1,0
326,258,314,-68,-12,0.3992070856685632,0.48138344261012056,0.11940947172131615,0.4450684687296713,0.44086312585467397,0.11406840541565523,1,1,2,2,4,1,0
356,273,340,-83,-16,0.4896896441560544,0.39176103994561884,0.11854931589832668,0.4004579972402215,0.4877084995841449,0.11183350317563369,0,0,1,2,0,1,0
285,250,356,-35,71,0.38431693190853944,0.49786058457636895,0.11782248351509175,0.36063762522229104,0.5266948148016477,0.112667559976061,1,1,1,2,4,0,0
301,177,257,-124,-44,0.4742054346367909,0.41160136647752105,0.11419319888568764,0.43661278068856857,0.45154375107767136,0.11184346823376005,1,1,1,1,4,1,0
313,251,327,-62,14,0.4722934018006974,0.41530301794176,0.1124035802575425,0.530270102290701,0.35394584597798967,0.11578405173130918,0,1,2,1,1,0,0
261,198,285,-63,24,0.4549960092163156,0.42034385537888386,0.12466013540480031,0.4434334534546363,0.44748117814098826,0.10908536840437547,1,0,1,1,2,0,0
298,207,275,-91,-23,0.435242124161234,0.4677718253902336,0.09698605044853245,0.4050570096434596,0.48191374706172163,0.11302924329481873,1,0,2,1,2,1,0
294,0,171,-294,-123,0.5046185379764574,0.38497618019578195,0.1104052818277609,0.4447960869387069,0.44200887108444425,0.11319504197684871,0,0,1,1,0,1,0
339,244,311,-95,-28,0.44086760203955555,0.4403981850324649,0.11873421292797956,0.41691895698341536,0.4711288551892911,0.11195218782729364,1,0,2,1,2,1,0
564,386,517,-178,-47,0.40138545419941263,0.4785774297356975,0.12003711606488991,0.5400639894304954,0.3411363930717317,0.11879961749777276,0,0,4,2,0,1,0
440,0,494,-440,54,0.6078263996749049,0.28998250539416653,0.1021910949309284,0.5429130184438516,0.3430458962856406,0.11404108527050759,1,0,1,3,2,0,0
461,322,414,-139,-47,0.27118383210891694,0.5837985952722476,0.14501757261883538,0.6141637879695694,0.2679614825414142,0.11787472948901617,0,1,2,1,1,1,0
466,299,428,-167,-38,0.4302971038508049,0.46289847039912235,0.10680442575007297,0.4483546813120475,0.44476102930065453,0.10688428938729777,1,0,3,2,2,1,0
367,275,339,-92,-28,0.4421428682587407,0.4583918803524601,0.09946525138879898,0.5426859712382601,0.34275312370805644,0.11456090505368353,0,0,1,1,0,1,0
515,322,507,-193,-8,0.48261858933378204,0.3920829001193904,0.12529851054682745,0.3673981188098816,0.5218131474365213,0.11078873375359664,0,1,1,2,1,1,0
311,203,259,-108,-52,0.4052060492048446,0.4873875897291794,0.10740636106597605,0.29754182089570813,0.5896411409320322,0.11281703817225948,0,1,1,1,1,1,0
366,178,194,-188,-172,0.45305435826638707,0.4152076396378553,0.1317380020957575,0.4027890232032815,0.4755281669778069,0.12168280981891184,1,0,1,1,3,1,0
387,298,334,-89,-53,0.4349210937881387,0.4515788997666191,0.113500006445242,0.4112311273384919,0.4749679459915199,0.11380092666998805,0,1,3,1,1,1,0
318,262,291,-56,-27,0.37590786684938304,0.5020961698558881,0.1219959632947289,0.42669993688808855,0.4422143582899832,0.13108570482192813,1,1,1,1,4,1,0
297,342,450,45,153,0.3223742226718919,0.5636433437873952,0.11398243354071272,0.3465766336023315,0.5447914267334277,0.10863193966424066,1,0,1,3,2,0,1
309,330,356,21,47,0.4560646801772651,0.41989577112542065,0.12403954869731461,0.4930737712288099,0.3909195685175674,0.11600666025362254,1,0,2,2,2,0,1
356,265,317,-91,-39,0.36780172585966414,0.49302332422997636,0.13917494991035953,0.4679629481436238,0.4119071320351236,0.12012991982125225,1,0,1,1,2,1,0
306,187,257,-119,-49,0.519598850856258,0.37836152833051,0.10203962081323191,0.4394711305441212,0.4477748231417286,0.11275404631415005,1,0,2,1,2,1,0
276,231,269,-45,-7,0.5121978750035691,0.3763485358203911,0.11145358917603981,0.49360166582941917,0.39263336267134624,0.11376497149923477,0,1,2,1,1,1,0
257,188,219,-69,-38,0.21471578427929702,0.6688009516202308,0.11648326410047224,0.49753784717077654,0.3835254556339834,0.11893669719523985,0,0,1,1,0,1,0
315,223,294,-92,-21,0.2680797533733539,0.5980941804185331,0.1338260662081127,0.37367980033554876,0.5158430946472449,0.1104771050172062,0,0,1,1,0,1,0
321,255,284,-66,-37,0.4171272987854261,0.47659633135763363,0.10627636985694042,0.5411780283567241,0.34611448545044243,0.11270748619283327,0,0,4,4,0,1,0
238,245,292,7,54,0.4199966560483977,0.4727321453269379,0.10727119862466447,0.47512235928229585,0.41398233339276164,0.11089530732494268,1,0,3,1,3,0,1
341,214,254,-127,-87,0.3862823539295259,0.4757079960335126,0.13800965003696133,0.4297922010196266,0.45988533709539653,0.11032246188497709,1,0,1,1,3,1,0
330,264,309,-66,-21,0.4936211176121609,0.3866806328780352,0.11969824950980396,0.42003689797886123,0.46990316348323746,0.1100599385379009,1,0,3,1,2,1,0
291,207,245,-84,-46,0.44206804938416866,0.4482136674882166,0.10971828312761478,0.4528277711172812,0.4330514501549027,0.11412077872781622,0,0,1,1,0,1,0
336,244,287,-92,-49,0.4933352050871692,0.3855979277313262,0.12106686718150468,0.39628068738075617,0.49256712444627765,0.11115218817296614,0,0,1,1,0,1,0
329,270,346,-59,17,0.3827075317063137,0.5170269841146433,0.100265484179043,0.39294737417123765,0.49605488187087343,0.11099774395788883,0,0,1,3,0,0,0
281,180,210,-101,-71,0.3830786636440315,0.4884633745104566,0.12845796184551198,0.47009565552203186,0.4184143542202429,0.11148999025772505,1,0,1,2,2,1,0
235,263,286,28,51,0.5468974682097513,0.34369163120869406,0.10941090058155478,0.49229950914828446,0.3944741848445257,0.11322630600719016,1,0,3,1,2,0,1
292,225,240,-67,-52,0.4070577797702693,0.4697169155388552,0.12322530469087559,0.4184525110081055,0.471196644932091,0.11035084405980351,1,0,2,2,3,1,0
295,131,269,-164,-26,0.5024902103522931,0.38993031830364566,0.10757947134406123,0.43647952400967593,0.4513842829429204,0.11213619304740363,1,0,1,1,2,1,0
280,198,267,-82,-13,0.45862560232185196,0.43409248743129036,0.10728191024685793,0.5452309980735973,0.3402323582963816,0.11453664363002147,0,1,2,1,1,1,0
751,504,546,-247,-205,0.26883813303702087,0.6026450497331564,0.1285168172298227,0.4855989781103687,0.40010149662829847,0.11429952526133272,0,0,3,1,0,1,0
227,156,210,-71,-17,0.5407865626709512,0.36443077330795276,0.09478266402109643,0.44584059479208243,0.4440535365128937,0.11010586869502387,1,1,2,2,4,1,0
307,270,284,-37,-23,0.46940913423297187,0.42023110556364046,0.1103597602033876,0.4715051220316737,0.41798832340026976,0.1105065545680565,0,0,4,1,0,1,0
294,155,186,-139,-108,0.4218875278391032,0.4607300048210666,0.11738246733983022,0.49249714261075933,0.3914970775816687,0.11600577980757182,1,0,2,2,2,1,0
265,208,228,-57,-37,0.6186861980466263,0.28902813357625307,0.09228566837712075,0.42282625950203123,0.46302376182405686,0.11414997867391184,0,0,1,2,0,1,0
270,230,254,-40,-16,0.4058127918564968,0.47785104189590044,0.11633616624760257,0.4531906704120232,0.4359165710588439,0.11089275852913288,1,1,3,2,4,1,0
246,268,307,22,61,0.491706812416954,0.38253279031378484,0.1257603972692613,0.44430808133626415,0.4348502131107431,0.12084170555299258,0,0,1,2,0,0,1
225,10,147,-215,-78,0.4557224434007982,0.4290871915721829,0.11519036502701878,0.5060840082683767,0.3802297510495634,0.11368624068205987,0,1,1,1,1,1,0
325,312,339,-13,14,0.29579633181906806,0.5732348382767088,0.1309688299042233,0.3981723944999144,0.491113616159815,0.11071398934027049,1,1,1,2,4,0,0
381,307,357,-74,-24,0.40315702699925593,0.4867281157551789,0.1101148572455652,0.46949143902073076,0.4163056560291452,0.1142029049501238,1,0,1,1,2,1,0
333,128,235,-205,-98,0.40073079945191525,0.4766322714241656,0.12263692912391909,0.46567328583800677,0.41158672928347095,0.12273998487852233,1,0,1,1,2,1,0
236,289,361,53,125,0.3115674470710944,0.5502158487768409,0.13821670415206497,0.4718684924974901,0.4066358763535753,0.12149563114893451,1,0,1,1,2,0,1
427,319,365,-108,-62,0.33213706313567454,0.5354116885226073,0.13245124834171787,0.3872222223048664,0.500810573222749,0.11196720447238455,0,1,1,1,1,1,0
272,212,253,-60,-19,0.4107337830469814,0.47849681538850924,0.11076940156450953,0.42823434449830916,0.4589737883707979,0.11279186713089308,1,0,1,2,3,1,0
433,80,200,-353,-233,0.5046185379764574,0.38497618019578195,0.1104052818277609,0.4447960869387069,0.44200887108444425,0.11319504197684871,0,1,1,2,1,1,0
403,246,276,-157,-127,0.4622141314849135,0.39271074519700644,0.14507512331808026,0.3350564355374287,0.554514804506234,0.11042875995633733,1,1,2,2,4,1,0
364,106,153,-258,-211,0.4402050914941947,0.4148271797827334,0.1449677287230717,0.4343187184708955,0.4423597043925892,0.12332157713651523,1,0,1,1,2,1,0
268,255,278,-13,10,0.43605774206004877,0.4259661687069376,0.13797608923301355,0.35902369009232704,0.5304838306518328,0.11049247925584008,1,0,2,2,2,0,0
335,265,375,-70,40,0.3902550773719726,0.4910212296285561,0.11872369299947111,0.3524503520494605,0.5387056811543786,0.10884396679616075,1,1,1,2,4,0,0
274,194,231,-80,-43,0.4676586896820286,0.4216499284968453,0.11069138182112621,0.3828867740147684,0.5066783254819268,0.11043490050330508,1,1,1,2,4,1,0
292,226,258,-66,-34,0.4743444610364262,0.4052285231625293,0.12042701580104442,0.5370642568836018,0.33275787998922035,0.13017786312717777,0,0,1,1,0,1,0
314,242,301,-72,-13,0.4862232487065535,0.3990631795241774,0.11471357176926893,0.42902568417932846,0.45950760837426624,0.11146670744640569,1,0,1,2,2,1,0
313,284,296,-29,-17,0.4526562911965821,0.4252760102564566,0.12206769854696123,0.5356866720017291,0.3481751443785984,0.11613818361967232,1,1,1,1,4,1,0
520,325,390,-195,-130,0.41673087064778247,0.45504528215504336,0.1282238471971742,0.5047916062135961,0.37566981828860047,0.1195385754978037,0,1,2,1,1,1,0
281,251,261,-30,-20,0.42434075560684875,0.47296294502228836,0.1026962993708628,0.47314137596903283,0.41576291853596814,0.11109570549499921,1,0,3,4,3,1,0
399,309,344,-90,-55,0.4283766900827457,0.44873803156356457,0.12288527835368959,0.49843608603296674,0.3865431924212665,0.11502072154576666,0,0,1,2,0,1,0
423,403,442,-20,19,0.3902902334735958,0.4545486619740433,0.15516110455236093,0.5379266096805421,0.34731806571837986,0.11475532460107807,1,0,2,3,2,0,0
378,318,337,-60,-41,0.36766782139968307,0.5099459964434543,0.12238618215686237,0.3985570334688569,0.48917639914429245,0.11226656738685058,1,0,1,2,2,1,0
356,234,260,-122,-96,0.5375882260787116,0.34878623577803053,0.1136255381432578,0.5420254089229255,0.3440548774717678,0.11391971360530646,0,0,3,1,0,1,0
828,908,939,80,111,0.3371246194011064,0.5446183476212204,0.11825703297767313,0.3686263118708028,0.5211987472284063,0.11017494090079093,1,0,1,3,2,0,1
283,223,254,-60,-29,0.4986941533717962,0.40243432837959364,0.09887151824861005,0.543313212166044,0.34321805708295794,0.11346873075099814,0,0,2,1,0,1,0
295,306,371,11,76,0.4274444277502718,0.4598569367481621,0.11269863550156588,0.527862283278861,0.3585519133698233,0.11358580335131555,1,0,1,1,2,0,1
299,175,236,-124,-63,0.41614054441410064,0.4728073569518262,0.11105209863407296,0.46286886949899453,0.42093687578599226,0.11619425471501303,1,0,1,1,2,1,0
336,202,305,-134,-31,0.5214795773735577,0.3756280374072574,0.10289238521918498,0.5323007344439415,0.35072529312655815,0.11697397242950025,0,1,1,1,1,1,0
383,272,299,-111,-84,0.3324438084451694,0.539969727040048,0.12758646451478256,0.3960077730953455,0.4943161576580468,0.10967606924660774,1,0,1,2,3,1,0
219,240,270,21,51,0.5391299641877342,0.3439610917565175,0.1169089440557483,0.4948953106584699,0.38723984256332294,0.11786484677820684,1,0,2,2,2,0,1
398,159,202,-239,-196,0.5049335551782816,0.3797045479930439,0.11536189682867436,0.3913881390866889,0.4964525343133322,0.11215932659997917,0,1,1,1,1,1,0
262,190,210,-72,-52,0.40479937647588415,0.4749968198263887,0.12020380369772683,0.38713741847176764,0.5004734367799226,0.1123891447483099,1,1,2,1,4,1,0
658,422,574,-236,-84,0.31543573589078994,0.529020585063301,0.155543679045909,0.3400512917848627,0.5502062991912543,0.10974240902388288,0,0,1,1,0,1,0
284,244,264,-40,-20,0.36507362058316983,0.5164038309488649,0.11852254846796535,0.4782338338265731,0.40381322468489766,0.11795294148852914,1,0,2,1,2,1,0
331,230,356,-101,25,0.44614557407396266,0.43432897375513063,0.11952545217090656,0.38910107691838447,0.5014272566058606,0.10947166647575496,1,1,1,4,4,0,0
323,180,276,-143,-47,0.4807846231908711,0.41728872750778767,0.10192664930134139,0.44642533308112203,0.4423602213481069,0.1112144455707711,1,1,1,1,4,1,0
279,134,244,-145,-35,0.38979675094413385,0.469334883186617,0.14086836586924897,0.5210616977293837,0.36849075940855586,0.11044754286206046,1,1,1,1,4,1,0
267,216,233,-51,-34,0.41816546753769057,0.4675379064455925,0.11429662601671711,0.4959352012951335,0.38633015216149197,0.1177346465433746,0,0,1,3,0,1,0
428,355,377,-73,-51,0.4722590286841953,0.4178650205594518,0.10987595075635292,0.393922169511168,0.49344568576913805,0.1126321447196937,0,0,1,2,0,1,0
257,152,237,-105,-20,0.35685365967923943,0.5239261650552051,0.11922017526555526,0.4609365350295406,0.4291267956075179,0.1099366693629416,0,0,2,1,0,1,0
289,244,258,-45,-31,0.4034910752776855,0.4657284577429587,0.13078046697935555,0.5396052558757065,0.34084764337744805,0.1195471007468454,1,0,2,1,2,1,0
213,183,202,-30,-11,0.41444753482706664,0.4768230920341264,0.10872937313880705,0.4186606412289495,0.4685443239297815,0.11279503484126883,1,1,1,3,4,1,0
277,308,443,31,166,0.4958254322691801,0.4008166548426998,0.10335791288812024,0.46689307553755993,0.4180593199475543,0.1150476045148856,1,0,2,1,2,0,1
258,223,247,-35,-11,0.4793925304269431,0.41643138697744253,0.1041760825956145,0.42531339492553033,0.46388476269588647,0.11080184237858336,0,1,2,2,1,1,0
318,241,520,-77,202,0.38645860372798513,0.5008615934682545,0.11267980280376003,0.47255367632257367,0.4027997131755741,0.12464661050185212,1,0,2,1,2,0,0
350,135,317,-215,-33,0.508166802624995,0.38763351663263496,0.10419968074237022,0.45036373986837513,0.4371912202453564,0.11244503988626821,1,0,1,1,2,1,0
284,254,270,-30,-14,0.5366656625293101,0.36401945303687533,0.09931488443381459,0.539234562094907,0.34841743453108653,0.11234800337400638,1,0,3,2,2,1,0
262,213,233,-49,-29,0.4578522726736869,0.4349336005342139,0.10721412679209907,0.45729890652677646,0.42921930650216283,0.11348178697106076,1,0,2,1,2,1,0
431,378,416,-53,-15,0.3693363142711678,0.48088506992629415,0.14977861580253807,0.47306135310368924,0.41379608277925656,0.1131425641170541,0,0,1,2,0,1,0
324,353,370,29,46,0.4326942326667919,0.4488714339874487,0.11843433334575934,0.33261541153351726,0.5547110293327476,0.11267355913373527,1,0,1,1,2,0,1
405,265,515,-140,110,0.4490273902217045,0.46183960305381716,0.08913300672447859,0.4888850819374211,0.39936627219863774,0.11174864586394107,1,1,3,1,4,0,0
478,340,420,-138,-58,0.4395793788916943,0.4451305129052564,0.11529010820304952,0.46178655643261274,0.42527408467510314,0.1129393588922841,1,1,1,3,4,1,0
325,225,355,-100,30,0.36414504123906893,0.5182976135028243,0.11755734525810667,0.4187099507820658,0.46784034370833977,0.1134497055095942,1,0,1,1,2,0,0
652,696,857,44,205,0.5046185379764574,0.38497618019578195,0.1104052818277609,0.4447960869387069,0.44200887108444425,0.11319504197684871,1,0,1,1,2,0,1
402,227,388,-175,-14,0.4612278631117253,0.4124867001269038,0.12628543676137066,0.48508139431690994,0.4022717022841708,0.11264690339891913,0,0,1,1,0,1,0
278,295,323,17,45,0.4674293129218998,0.4168583564914999,0.11571233058660023,0.40080670677066915,0.489272500852202,0.10992079237712869,1,0,2,5,2,0,1
284,171,211,-113,-73,0.48326590598771507,0.40491415659261715,0.11181993741966775,0.49578360740747435,0.3892878260783217,0.11492856651420402,1,0,1,1,2,1,0
343,182,247,-161,-96,0.4730407489716911,0.421735947355357,0.10522330367295181,0.3512394165557554,0.5394230568690264,0.1093375265752183,1,0,2,1,2,1,0
404,0,24,-404,-380,0.41193370893368686,0.48598214968256426,0.10208414138374887,0.5098905166930207,0.36629564935133146,0.12381383395564788,1,1,1,1,4,1,0
379,182,390,-197,11,0.4068034467504528,0.4691701029194771,0.12402645033007016,0.383144528105821,0.5077973823018069,0.10905808959237184,1,0,1,1,2,0,0
238,191,414,-47,176,0.3820872190860398,0.48049883973171065,0.13741394118224975,0.5322094802212288,0.3498369816059395,0.11795353817283154,1,0,1,1,2,0,0
265,282,361,17,96,0.5576671672403662,0.3399720978778096,0.10236073488182428,0.5330168751278994,0.35667184493865384,0.11031127993344668,1,0,1,2,2,0,1
291,199,253,-92,-38,0.5100132724121598,0.3793722509631709,0.1106144766246693,0.4944158815595475,0.3913569664354446,0.11422715200500799,0,0,1,3,0,1,0
290,215,314,-75,24,0.5432044737938395,0.34316157689659843,0.11363394930956215,0.4053480655122624,0.4875749435521674,0.1070769909355703,1,0,1,4,2,0,0
296,252,282,-44,-14,0.40043124177900385,0.4598126315697115,0.13975612665128467,0.41960819510093406,0.47157923986106587,0.10881256503799985,1,0,2,1,2,1,0
273,213,258,-60,-15,0.41117625049590767,0.4231612383840511,0.1656625111200412,0.4511622403568907,0.4328001636422956,0.11603759600081386,1,1,1,2,4,1,0
305,215,248,-90,-57,0.3308327277627869,0.5450876861932434,0.1240795860439697,0.37304028182972826,0.5160917697824677,0.11086794838780402,0,0,1,1,0,1,0
461,276,343,-185,-118,0.27727207184187125,0.6094924883700683,0.11323543978806043,0.390852714025352,0.49775359123983354,0.11139369473481468,1,1,1,4,4,1,0
266,82,198,-184,-68,0.4545645704265547,0.43184020903501574,0.11359522053842952,0.4556550403698634,0.4305238750015008,0.11382108462863591,1,0,1,1,2,1,0
369,390,563,21,194,0.4819729059445245,0.41881491330700027,0.0992121807484752,0.5414668209911312,0.3451966805367984,0.11333649847207052,1,0,3,1,2,0,1
369,278,359,-91,-10,0.46194274887036985,0.4146652887798412,0.1233919623497891,0.46458677606026294,0.41957674678326184,0.11583647715647521,0,1,1,1,1,1,0
279,243,270,-36,-9,0.4367206342768108,0.4439297777017664,0.11934958802142268,0.3922761361287917,0.49587050814896205,0.11185335572224597,0,0,4,1,0,1,0
413,305,342,-108,-71,0.4330055755543368,0.4425741792773714,0.12442024516829193,0.4724087562992536,0.4102839189453751,0.11730732475537126,0,0,3,1,0,1,0
305,189,219,-116,-86,0.39899981086474656,0.4795091819114895,0.12149100722376391,0.35779960296808466,0.5344697870895799,0.10773060994233548,0,0,1,2,0,1,0
187,143,152,-44,-35,0.4367920420876513,0.4191423660587308,0.14406559185361822,0.44879439796281323,0.4395376159085782,0.1116679861286084,0,1,1,3,1,1,0
402,217,254,-185,-148,0.4578294105519009,0.440513235433583,0.10165735401451587,0.5218064895068185,0.3577458400707502,0.12044767042243099,0,0,3,1,0,1,0
331,227,243,-104,-88,0.4418362659610478,0.44153814054250823,0.1166255934964438,0.536847635282039,0.34195270065435657,0.12119966406360415,1,0,1,1,2,1,0
329,148,178,-181,-151,0.3764220191183194,0.48620396823159356,0.13737401265008686,0.39819963988921503,0.4890039536264944,0.11279640648429075,1,0,1,1,3,1,0
299,232,266,-67,-33,0.5445854009055874,0.35626709649681615,0.09914750259759615,0.43360053268083815,0.4559811586702067,0.11041830864895523,1,0,1,1,2,1,0
303,182,250,-121,-53,0.459151980502224,0.4268271848235793,0.1140208346741964,0.3832165228448212,0.5032197100389486,0.1135637671162303,1,0,3,1,3,1,0
329,193,205,-136,-124,0.3285272784903679,0.5467736771322657,0.12469904437736608,0.392816801924561,0.49576080627247193,0.1114223918029668,0,0,1,2,0,1,0
361,213,314,-148,-47,0.48681287458087774,0.4017411431751409,0.11144598224398118,0.4229568082022274,0.46512940220513926,0.11191378959263336,1,0,1,1,2,1,0
316,279,305,-37,-11,0.4161278583327903,0.4491394313455293,0.13473271032168044,0.41890921646616386,0.4703555244201533,0.11073525911368268,0,1,1,3,1,1,0
368,289,332,-79,-36,0.3491467125734048,0.532643826162253,0.11820946126434205,0.4044217466250197,0.48598832300524525,0.10958993036973508,1,0,1,1,2,1,0
311,203,274,-108,-37,0.5497116851310725,0.3335923749230974,0.11669593994582993,0.5158823107093362,0.36507278858628367,0.11904490070438037,0,0,1,4,0,1,0
285,223,240,-62,-45,0.49032512653174726,0.3948305300971255,0.11484434337112726,0.44186184422048047,0.44632157042699777,0.11181658535252177,1,1,2,1,4,1,0
193,211,239,18,46,0.4441530054648024,0.42524595659834996,0.1306010379368475,0.4377741305619561,0.44512067827425417,0.11710519116378958,1,0,2,1,2,0,1
507,467,490,-40,-17,0.27043264850693116,0.6114611567268204,0.11810619476624833,0.37164292058067616,0.5160558825295339,0.11230119688979005,1,0,6,3,2,1,0
431,336,379,-95,-52,0.36411105948983646,0.5092726422440771,0.12661629826608645,0.4616757966427347,0.42432999565337554,0.11399420770388967,0,0,1,2,0,1,0
378,257,297,-121,-81,0.42176265003851726,0.4498459014297758,0.12839144853170717,0.5135152330145439,0.36789184141856807,0.11859292556688787,1,1,1,1,4,1,0
288,237,263,-51,-25,0.4128605489077115,0.4610501433700331,0.1260893077222556,0.495727735400366,0.387275778447624,0.11699648615200979,1,1,2,1,4,1,0
319,150,251,-169,-68,0.4624955972381636,0.4087799479007571,0.12872445486107917,0.5414963619816863,0.3447008477069824,0.11380279031133134,0,1,1,1,1,1,0
111,16,93,-95,-18,0.4747779999018188,0.39736177092885083,0.12786022916933062,0.5148216124071637,0.3703429085548376,0.1148354790379986,0,1,1,1,1,1,0
342,240,287,-102,-55,0.4288152953909802,0.45524127333277803,0.11594343127624167,0.46423919971349903,0.41980902110999097,0.11595177917650994,0,0,1,1,0,1,0
348,252,335,-96,-13,0.42042582038226994,0.45877360966795294,0.12080056994977707,0.46723742831397186,0.4168424303506374,0.11592014133539072,0,1,1,1,1,1,0
412,292,316,-120,-96,0.37993653754852946,0.4953081384819011,0.12475532396956947,0.4554714016197248,0.4330017081762896,0.11152689020398562,1,1,1,1,4,1,0
168,103,135,-65,-33,0.44172470726897284,0.44694007585480744,0.1113352168762199,0.532525236904268,0.35242595200803606,0.11504881108769593,1,1,2,1,4,1,0
306,324,361,18,55,0.48564328395208645,0.3924468012478486,0.12190991480006516,0.3873244313396173,0.4987391008970149,0.11393646776336773,0,0,1,1,0,0,1
586,494,524,-92,-62,0.37923298007989026,0.44554674150169676,0.175220278418413,0.32683852351767284,0.5618521632862087,0.11130931319611859,1,0,1,1,3,1,0
335,313,360,-22,25,0.325502365357679,0.5670893677303841,0.10740826691193671,0.3977731398063004,0.4894487033401216,0.11277815685357806,1,1,1,1,4,0,0
416,306,321,-110,-95,0.3945374487830926,0.4895888246754133,0.115873726541494,0.4004150654886632,0.48982528178820917,0.1097596527231277,0,1,1,2,1,1,0
359,233,283,-126,-76,0.4524129682987145,0.4137278613983309,0.13385917030295452,0.3983509046641841,0.48992825205747664,0.11172084327833924,0,0,1,1,0,1,0
290,252,274,-38,-16,0.395442269154431,0.483486443784974,0.12107128706059499,0.4071718736712372,0.4795906845660935,0.11323744176266949,1,1,4,2,4,1,0
304,183,266,-121,-38,0.33441486538067905,0.5485788251389959,0.11700630948032474,0.5307385045789433,0.35442076737777783,0.11484072804327904,1,1,3,1,4,1,0
319,158,177,-161,-142,0.45867375229735274,0.40197576867771456,0.13935047902493242,0.5655468722157344,0.31537364368957826,0.11907948409468744,0,1,2,1,1,1,0
286,211,245,-75,-41,0.4741013363801398,0.3912639609607737,0.13463470265908664,0.5411990424293494,0.34234300779542637,0.11645794977522435,1,0,2,1,2,1,0
344,158,266,-186,-78,0.3672376649319617,0.4658797291644295,0.16688260590360887,0.43561628856210743,0.45540928142524356,0.10897443001264892,0,1,1,2,1,1,0
459,393,423,-66,-36,0.3936705851393931,0.42926975469322837,0.17705966016737873,0.5368907264567554,0.3476965208645159,0.11541275267872848,1,0,3,1,2,1,0
364,293,343,-71,-21,0.18985451954281854,0.6451889676566581,0.16495651280052331,0.43889036336644494,0.442594242876679,0.11851539375687614,0,1,3,1,1,1,0
194,220,271,26,77,0.5234110246883211,0.3667376383538362,0.10985133695784274,0.4946314410878587,0.38744036151271066,0.11792819739943085,1,0,2,1,2,0,1
426,346,383,-80,-43,0.39188309702269,0.5049027412486586,0.10321416172865153,0.5124077312311662,0.3685362016716878,0.11905606709714599,1,0,2,2,2,1,0
524,322,336,-202,-188,0.47744377780069397,0.4115274727124448,0.11102874948686123,0.5437975239566852,0.33898597827750304,0.11721649776581147,1,0,1,1,2,1,0
357,254,338,-103,-19,0.4779186834952815,0.4108597986917959,0.11122151781292249,0.4831125373696272,0.4022745650807171,0.11461289754965572,1,1,1,1,4,1,0
388,398,414,10,26,0.44092317488189137,0.43752472332111186,0.12155210179699691,0.47092530845670083,0.41565729694172765,0.11341739460157178,1,0,1,1,2,0,1
55,70,119,15,64,0.5046185379764574,0.38497618019578195,0.1104052818277609,0.4447960869387069,0.44200887108444425,0.11319504197684871,1,0,1,1,2,0,1
521,619,672,98,151,0.2560217161721439,0.5975754169756647,0.14640286685219117,0.3972939830312633,0.47361818209468604,0.12908783487405048,1,0,1,1,2,0,1
407,317,375,-90,-32,0.4210043219627038,0.4486827113541524,0.13031296668314382,0.48388422244563306,0.39954467233898117,0.11657110521538556,1,1,2,1,4,1,0
291,115,261,-176,-30,0.4881281017018957,0.40553962467998605,0.10633227361811819,0.44576340898813654,0.4419971539523857,0.1122394370594775,1,0,1,1,2,1,0
253,208,232,-45,-21,0.47195530812278835,0.42421335464650145,0.10383133723071025,0.4478346644703099,0.44166394118185065,0.1105013943478393,1,0,1,1,2,1,0
327,254,368,-73,41,0.3098671524801157,0.5601033803009368,0.13002946721894762,0.4366277874889424,0.4513994914800674,0.11197272103099026,0,0,1,2,0,0,0
267,208,249,-59,-18,0.32813706763598316,0.5335782395551383,0.1382846928088786,0.3933021249759572,0.496159498071965,0.11053837695207779,1,0,2,2,3,1,0
272,230,258,-42,-14,0.38420432132837046,0.49984501010271626,0.11595066856891355,0.4138637813524379,0.47258200535936407,0.11355421328819813,1,0,1,2,2,1,0
264,246,281,-18,17,0.46322387304671847,0.41861241377002995,0.11816371318325149,0.4577976531705166,0.43021772601032227,0.11198462081916098,1,0,1,1,2,0,0
269,205,286,-64,17,0.4681241502309616,0.4178405452176287,0.11403530455140996,0.4627365789949191,0.4220198821563468,0.11524353884873405,1,0,1,1,2,0,0
211,231,248,20,37,0.45907749050674657,0.43017959902390246,0.11074291046935082,0.4056160042565185,0.4819780507323774,0.11240594501110407,1,0,1,1,2,0,1
262,165,221,-97,-41,0.35154346958739374,0.5209694207645169,0.1274871096480896,0.42279437847021467,0.4676788332851692,0.10952678824461634,0,0,1,1,0,1,0
339,261,314,-78,-25,0.4842590765906027,0.423080573577861,0.09266034983153619,0.4240632979117164,0.4662051098985035,0.10973159218978033,1,0,2,1,2,1,0
255,36,102,-219,-153,0.4148492532570642,0.4645189887820506,0.12063175796088536,0.5035868784064692,0.3629815048627349,0.13343161673079584,0,0,1,1,0,1,0
446,394,430,-52,-16,0.4847048562516045,0.3981965376389492,0.11709860610944645,0.3817110029471692,0.5055511925060988,0.11273780454673138,1,0,1,1,2,1,0
227,196,213,-31,-14,0.47999173339635703,0.4098556565417648,0.11015261006187836,0.46910985203437366,0.4183097592127949,0.11258038875283115,1,0,1,2,2,1,0
392,412,473,20,81,0.4257579628639478,0.4559421122439192,0.11829992489213297,0.4723884915680318,0.40856156192855797,0.11904994650340985,1,1,1,1,4,0,1
263,145,187,-118,-76,0.45035739331708124,0.42495861800075985,0.124683988682159,0.5000542137664368,0.37325450898746243,0.1266912772461007,0,1,1,1,1,1,0
291,223,239,-68,-52,0.5055470437033199,0.356292836488266,0.1381601198084142,0.5126801507715385,0.3723459815099348,0.11497386771852688,0,0,3,1,0,1,0
270,177,216,-93,-54,0.37025720411629287,0.5105990873504083,0.11914370853329875,0.4005046884496124,0.4866496330976972,0.11284567845269049,1,0,3,4,2,1,0
359,252,372,-107,13,0.20116288570655502,0.6716579439871888,0.12717917030625625,0.4651669746664249,0.42439635886629645,0.11043666646727837,1,0,1,2,2,0,0
191,221,234,30,43,0.44220713337996903,0.44337273482313766,0.11442013179689288,0.4812931687770087,0.404708577341696,0.11399825388129521,1,0,2,1,2,0,1
305,273,288,-32,-17,0.3948796996971387,0.4640571455875816,0.14106315471527953,0.4489319987316899,0.43988456791704117,0.11118343335126893,1,0,1,2,2,1,0
218,241,269,23,51,0.4452873196928652,0.43653425780697735,0.11817842250015745,0.37721260269216883,0.5122339429044608,0.11055345440337032,1,0,2,3,2,0,1
277,251,322,-26,45,0.44956186518878294,0.43310249109480514,0.11733564371641231,0.47429907118657283,0.41427594071528817,0.11142498809813886,1,0,1,3,2,0,0
274,216,226,-58,-48,0.4395468838325345,0.4476778307105508,0.11277528545691495,0.3962088699697088,0.4919625966498755,0.11182853338041585,1,0,1,2,3,1,0
322,279,303,-43,-19,0.4271213492142009,0.4475318312209321,0.12534681956486693,0.43730661339119015,0.45049509384945363,0.11219829275935629,1,1,2,2,4,1,0
300,254,274,-46,-26,0.4512351043046248,0.4365557298921237,0.11220916580325153,0.5161058465111175,0.3676504757490119,0.11624367773987078,0,0,4,4,0,1,0
303,161,269,-142,-34,0.2603669030143323,0.6155283157408052,0.12410478124486232,0.5317082813733922,0.35377031495157674,0.11452140367503101,0,0,1,1,0,1,0
278,215,287,-63,9,0.4369092996666508,0.44478508489506,0.11830561543828906,0.4770085043244703,0.400419047628138,0.12257244804739148,1,0,1,1,2,0,0
322,371,430,49,108,0.46778795104504745,0.3988029230844234,0.1334091258705291,0.4223705052711787,0.4690889626515101,0.10854053207731108,1,0,1,4,2,0,1
304,365,418,61,114,0.44754495922101534,0.4281757717828488,0.12427926899613563,0.4039402896679568,0.4849241833261641,0.11113552700587905,1,1,1,2,4,0,1
373,274,311,-99,-62,0.5694884156898168,0.2960744930298803,0.1344370912803026,0.4206400097345484,0.46768292393901184,0.11167706632643984,0,1,2,1,1,1,0
136,0,85,-136,-51,0.5046185379764574,0.38497618019578195,0.1104052818277609,0.4447960869387069,0.44200887108444425,0.11319504197684871,0,0,1,1,0,1,0
475,340,389,-135,-86,0.2887841980511673,0.6281331450185663,0.08308265693026619,0.5073221907390183,0.37743275921365627,0.11524505004732538,0,1,1,1,1,1,0
551,441,475,-110,-76,0.4013837611220523,0.4848423709046208,0.11377386797332675,0.3596664665667622,0.5269953384311358,0.11333819500210211,0,1,2,2,1,1,0
327,303,351,-24,24,0.4702717056032351,0.40261118132924467,0.12711711306752005,0.5431583645240274,0.3396890746368743,0.11715256083909799,0,0,6,1,0,0,0
274,163,191,-111,-83,0.4055420601515307,0.4936391518515564,0.10081878799691286,0.49278006313283756,0.3840496727076574,0.12317026415950492,0,0,2,1,0,1,0
285,210,345,-75,60,0.3034070099416271,0.5577450094101584,0.13884798064821435,0.3347082179273266,0.5562040876475739,0.10908769442509919,1,0,1,3,2,0,0
58,0,43,-58,-15,0.49727107484177185,0.39277560517228566,0.1099533199859424,0.4461157298935057,0.44042564731334466,0.11345862279314979,0,0,1,1,0,1,0
419,145,187,-274,-232,0.40357214349392534,0.4496347797095425,0.14679307679653203,0.4674539886874001,0.4024289792429818,0.13011703206961842,1,0,1,3,2,1,0
284,78,109,-206,-175,0.5046185379764574,0.38497618019578195,0.1104052818277609,0.4447960869387069,0.44200887108444425,0.11319504197684871,0,0,1,1,0,1,0
383,334,360,-49,-23,0.2771207217763359,0.6172233277465475,0.10565595047711665,0.4550716957157207,0.42995343669287955,0.11497486759139952,1,1,2,4,4,1,0
290,219,235,-71,-55,0.506871709567977,0.39273990759338506,0.10038838283863814,0.44401382869609557,0.4451924870886329,0.11079368421527151,1,0,3,2,3,1,0
327,219,344,-108,17,0.40390273226688805,0.4796442756216323,0.11645299211147976,0.34488004340901196,0.5425990001242045,0.1125209564667834,1,1,3,3,4,0,0
423,246,286,-177,-137,0.4904710020664186,0.40820663036901106,0.10132236756457053,0.5440973995813935,0.3444866101472959,0.11141599027131044,0,0,2,1,0,1,0
624,726,809,102,185,0.4323848484472594,0.4600487236161719,0.10756642793656852,0.4969959692791603,0.39215491085645454,0.11084911986438534,0,0,5,1,0,0,1
597,485,582,-112,-15,0.4723671063930693,0.41874462602380996,0.10888826758312038,0.427290242686463,0.4616843533990254,0.11102540391451154,1,1,3,1,4,1,0
383,255,289,-128,-94,0.2291952403457076,0.6194788436332728,0.1513259160210194,0.523203991696566,0.35535054532787774,0.12144546297555632,1,0,3,1,2,1,0
431,373,402,-58,-29,0.20469005042101443,0.6425975658200676,0.15271238375891805,0.40428292189888954,0.48315946761693485,0.11255761048417526,1,1,4,3,4,1,0
276,132,219,-144,-57,0.3430279377093519,0.5293740538371767,0.12759800845347122,0.39191224689321075,0.49585827766428575,0.1122294754425036,1,0,1,3,2,1,0
249,193,268,-56,19,0.4137405627052619,0.4698136585810741,0.1164457787136639,0.3599673634182909,0.5266364770740194,0.11339615950768972,0,0,1,4,0,0,0
259,178,221,-81,-38,0.4825280462202666,0.3994975045063316,0.11797444927340171,0.5244060488194001,0.35941045529971016,0.11618349588088966,0,0,2,1,0,1,0
328,348,365,20,37,0.37349744734740103,0.4870206147229644,0.13948193792963476,0.3943905935478887,0.49285094582271943,0.11275846062939182,1,1,2,3,4,0,1
124,79,103,-45,-21,0.506279813338706,0.38043783465009867,0.11328235201119523,0.48500541864386876,0.39648084468565453,0.11851373667047665,1,0,1,2,2,1,0
296,123,209,-173,-87,0.5046185379764574,0.38497618019578195,0.1104052818277609,0.4447960869387069,0.44200887108444425,0.11319504197684871,0,0,1,1,0,1,0
108,67,79,-41,-29,0.5046185379764574,0.38497618019578195,0.1104052818277609,0.4447960869387069,0.44200887108444425,0.11319504197684871,0,1,1,1,1,1,0
398,255,374,-143,-24,0.49711844437792124,0.40214049164521004,0.10074106397686884,0.541755121857166,0.345148391705022,0.11309648643781174,0,0,2,1,0,1,0
283,198,248,-85,-35,0.5200403467574162,0.3651751255468712,0.11478452769571251,0.42452805700605944,0.4646302418152394,0.11084170117870124,1,0,1,1,2,1,0
320,264,304,-56,-16,0.5022377038333031,0.3793773076609321,0.11838498850576477,0.46226062427516385,0.42492778591791946,0.11281158980691651,1,0,2,2,3,1,0
271,187,215,-84,-56,0.4623411560351904,0.4252235106317745,0.1124353333330352,0.44423649987751496,0.44474615116307764,0.11101734895940762,1,0,2,1,2,1,0
400,239,299,-161,-101,0.4382237640829986,0.4355168878853761,0.12625934803162525,0.5319438540161961,0.34989508265857744,0.11816106332522645,0,1,1,1,1,1,0
379,247,363,-132,-16,0.4628917854817082,0.4007504562141621,0.13635775830412974,0.5386525039601986,0.34823224638562905,0.11311524965417236,0,0,1,1,0,1,0
409,339,370,-70,-39,0.5415161682424438,0.342745480637243,0.11573835112031301,0.5463236506781878,0.34011547028440947,0.11356087903740265,1,1,1,1,4,1,0
293,394,480,101,187,0.5121355464741218,0.3845284010128797,0.10333605251299874,0.5408131622548287,0.3436406896222908,0.11554614812288024,1,0,3,2,2,0,1
461,375,426,-86,-35,0.452123127187731,0.42336905700507826,0.12450781580719089,0.505162984295014,0.3786066434536692,0.11623037225131659,1,1,1,4,4,1,0
455,481,586,26,131,0.33231349844322317,0.5649897229811649,0.10269677857561209,0.5443927823260959,0.34121934744028226,0.11438787023362199,1,0,4,1,2,0,1
299,327,360,28,61,0.45234969159317134,0.42835663044076233,0.11929367796606642,0.44801528998455453,0.4396910625396878,0.11229364747575782,1,0,1,1,2,0,1
418,332,370,-86,-48,0.38152040243045465,0.5043257825288692,0.1141538150406764,0.40015519087476076,0.4877107230318782,0.11213408609336113,1,1,1,4,4,1,0
310,318,369,8,59,0.36690116594519556,0.5051157533802376,0.12798308067456693,0.41411717364288514,0.46349645465147765,0.1223863717056373,1,0,1,1,3,0,1
331,280,317,-51,-14,0.5544527437260621,0.3442984988596547,0.10124875741428335,0.438001356932412,0.4511967865620024,0.11080185650558556,1,0,1,1,2,1,0
370,257,318,-113,-52,0.32697558680731753,0.5410703007392095,0.1319541124534731,0.47107043641156454,0.41849991053515173,0.11042965305328377,1,0,1,1,2,1,0
362,374,448,12,86,0.5038036015465729,0.39066158956568503,0.10553480888774212,0.544307864094596,0.3435787983094532,0.11211333759595114,1,0,5,1,2,0,1
276,288,442,12,166,0.44782139258515485,0.4424220575952361,0.10975654981960917,0.4719448323727789,0.40769430909012466,0.12036085853709635,1,0,2,1,2,0,1
267,313,335,46,68,0.3181376186705529,0.5725302783474984,0.10933210298194863,0.3731242630620991,0.521727228151417,0.10514850878648374,0,0,1,1,0,0,1
295,312,340,17,45,0.44196023104828924,0.4483330034442645,0.10970676550744629,0.3372379523664774,0.5499495976071778,0.11281245002634478,1,0,1,1,2,0,1
450,383,571,-67,121,0.19983746327583976,0.6924874220683127,0.10767511465584739,0.5420141877688487,0.3312676875759783,0.12671812465517315,1,0,3,2,2,0,0
535,486,515,-49,-20,0.32458746439581726,0.5521624452652234,0.12325009033895941,0.5451435715874917,0.3379826087895089,0.11687381962299924,1,0,2,1,2,1,0
165,0,107,-165,-58,0.5034489596721566,0.3699313497730058,0.12661969055483752,0.5148759321539497,0.36890204830607065,0.1162220195399795,0,1,1,1,1,1,0
481,329,439,-152,-42,0.415472899914871,0.4535429293226752,0.13098417076245372,0.5788644348384251,0.2973512902610031,0.1237842749005717,0,0,1,1,0,1,0
287,182,264,-105,-23,0.425435889209624,0.4619519209350675,0.11261218985530831,0.484069663207385,0.4041986022952319,0.1117317344973833,0,0,1,1,0,1,0
360,246,273,-114,-87,0.45529072368140194,0.4115054928466366,0.1332037834719616,0.4617211014262236,0.41942303980232637,0.11885585877145002,1,0,1,1,3,1,0
468,387,435,-81,-33,0.42561589167669295,0.4409816638034627,0.13340244451984443,0.4373860795152149,0.44937825202571774,0.11323566845906706,0,0,1,3,0,1,0
304,186,265,-118,-39,0.4253097241640152,0.4623471286684811,0.11234314716750377,0.4298360692766002,0.4486405958937264,0.12152333482967351,0,1,2,1,1,1,0
181,50,145,-131,-36,0.4777472801070658,0.41904911151148866,0.10320360838144561,0.52870681964566,0.3583478612984536,0.1129453190558866,1,0,3,1,2,1,0
319,264,305,-55,-14,0.4087329681137191,0.48522111922483635,0.10604591266144463,0.4472931939767102,0.4413056759056594,0.11140113011763059,0,0,1,2,0,1,0
481,261,348,-220,-133,0.44985444775581274,0.4118931280677746,0.13825242417641267,0.5460059781895993,0.3365767195106551,0.11741730229974562,0,0,1,4,0,1,0
374,336,363,-38,-11,0.4963709316027936,0.39495710612824275,0.1086719622689634,0.40714443964730185,0.48014008026099325,0.11271548009170516,1,0,3,1,2,1,0
294,334,389,40,95,0.4680578218224734,0.404859094573707,0.12708308360381926,0.4343997563424296,0.45619786839644727,0.10940237526112309,1,0,3,3,2,0,1
264,280,325,16,61,0.5887300660171859,0.3143809739705252,0.09688896001228894,0.4899667704983092,0.3976761267879399,0.11235710271375081,1,1,3,1,4,0,1
75,0,55,-75,-20,0.46883363103282283,0.4167587529865754,0.11440761598060173,0.4596949325442203,0.4273188334719221,0.11298623398385754,0,1,1,1,1,1,0
334,288,382,-46,48,0.35807141433910317,0.5179857193004994,0.12394286636039716,0.3899649360263079,0.5003086803960286,0.10972638357766347,1,0,2,2,2,0,0
485,286,433,-199,-52,0.4093131327022272,0.4530238254143913,0.13766304188338133,0.5322133334344922,0.3542494857521393,0.11353718081336842,0,0,2,1,0,1,0
635,544,577,-91,-58,0.2648497714602846,0.5676826220735517,0.16746760646616396,0.5267747970713501,0.30311834776273255,0.17010685516591734,1,0,1,1,2,1,0
269,331,359,62,90,0.5190150395402336,0.3748439981326844,0.10614096232708198,0.5312992153652688,0.35125406818400345,0.11744671645072782,0,1,2,3,1,0,1
551,268,356,-283,-195,0.5301132413547044,0.35050037051584293,0.11938638812945263,0.45388750674518596,0.43592789462183307,0.11018459863298079,1,0,2,2,2,1,0
472,392,449,-80,-23,0.45612959057438035,0.41630021482501756,0.1275701946006024,0.3695281049284829,0.5215864430572814,0.10888545201423559,1,1,2,2,4,1,0
231,131,176,-100,-55,0.48395072926765975,0.41045478051031886,0.10559449022202153,0.5013190161598454,0.3875596063289932,0.11112137751116147,0,0,1,1,0,1,0
235,0,124,-235,-111,0.42731880825011687,0.46304012609226025,0.10964106565762262,0.5213560129011259,0.3614566146293748,0.11718737246949934,0,1,1,1,1,1,0
309,246,265,-63,-44,0.47605664862892955,0.414370514600242,0.10957283677082842,0.46047192047379754,0.4222293006921984,0.11729877883400426,1,0,1,1,2,1,0
95,16,43,-79,-52,0.5278596990634598,0.3641177784689881,0.10802252246755202,0.4746746434130106,0.41213316863037086,0.11319218795661866,1,1,1,1,4,1,0
284,189,262,-95,-22,0.4501340824227581,0.4451713088195654,0.1046946087576764,0.46521640583020046,0.42609625558562786,0.10868733858417166,1,0,2,1,3,1,0
391,408,422,17,31,0.33176006089661564,0.5499115943713363,0.11832834473204813,0.4999179744603223,0.3846455307810258,0.11543649475865181,1,0,2,3,2,0,1
326,250,278,-76,-48,0.31298677663497926,0.5192589497158019,0.16775427364921885,0.3675574982750899,0.5186317178533463,0.11381078387156386,0,0,1,4,0,1,0
486,443,460,-43,-26,0.35929346839373527,0.509245783274942,0.13146074833132265,0.4204220880419992,0.4584427938809498,0.12113511807705117,1,0,3,1,2,1,0
255,180,205,-75,-50,0.3639144169453018,0.509598822037265,0.12648676101743295,0.49185623157372144,0.3904113174988164,0.11773245092746226,0,0,1,1,0,1,0
355,273,342,-82,-13,0.43593738868985193,0.4129744081551679,0.15108820315498012,0.5432086098899795,0.3338317806287392,0.12295960948128112,0,0,4,1,0,1,0
85,0,15,-85,-70,0.5085922571349157,0.3787761786636058,0.11263156420147852,0.5023566873356216,0.3840306744544418,0.11361263820993676,0,0,1,1,0,1,0
423,226,282,-197,-141,0.46335195703737403,0.4364890968992921,0.1001589460633339,0.4496494883154034,0.437903280933502,0.1124472307510945,1,0,1,4,2,1,0
498,411,516,-87,18,0.41892886730920953,0.36781619039688207,0.2132549422939084,0.5314666437624201,0.3144651510205075,0.1540682052170723,0,0,1,5,0,0,0
455,201,298,-254,-157,0.459924850346554,0.4349430566669586,0.1051320929864876,0.4318829008410143,0.4555408066973237,0.11257629246166159,0,0,1,1,0,1,0
291,241,268,-50,-23,0.4446837444165755,0.43388818978113314,0.12142806580229126,0.5217911193733976,0.3599944568304071,0.11821442379619523,1,1,1,2,4,1,0
269,218,290,-51,21,0.40901580446214647,0.45467878469585815,0.1363054108419951,0.4279643381438138,0.45886091700088655,0.11317474485529956,0,1,2,3,1,0,0
289,254,274,-35,-15,0.3518134779671432,0.5241140227597794,0.12407249927307738,0.40868755538525187,0.4800320570857778,0.11128038752897045,1,0,1,2,3,1,0
489,419,474,-70,-15,0.35978033583613184,0.5279909670763063,0.1122286970875623,0.466853291382058,0.4172266565421863,0.11592005207575556,1,0,1,1,2,1,0
326,264,279,-62,-47,0.3680136431597987,0.5023113636438602,0.12967499319634115,0.37075907380387907,0.5169590656021201,0.11228186059400093,1,0,1,2,2,1,0
365,250,303,-115,-62,0.3273005461427261,0.5566401936262938,0.11605926023097991,0.4001416074965808,0.48870829797847687,0.11115009452494261,0,0,3,2,0,1,0
317,272,293,-45,-24,0.3369013589598662,0.5265144424964358,0.13658419854369774,0.4101196268217974,0.47882039074420035,0.11105998243400196,1,0,2,3,2,1,0
582,438,452,-144,-130,0.4072770069234103,0.46878807974181863,0.12393491333477094,0.5405957354593922,0.33651554931531324,0.12288871522529458,0,0,2,1,0,1,0
312,350,481,38,169,0.4543593140305367,0.41182392332747864,0.1338167626419847,0.5259521437051012,0.3598522440342181,0.11419561226068047,1,0,2,1,2,0,1
791,701,751,-90,-40,0.4591297568176311,0.42947133907592233,0.11139890410644636,0.5439133254240789,0.339197493238219,0.11688918133770188,1,0,1,1,2,1,0
443,371,426,-72,-17,0.417322614895771,0.43601916517139877,0.1466582199328303,0.5389780276400139,0.33820190656126914,0.12282006579871714,0,0,3,2,0,1,0
143,85,118,-58,-25,0.4195874235538791,0.45495080913987435,0.1254617673062467,0.46024312463354056,0.4269454402420978,0.11281143512436169,0,1,1,2,1,1,0
439,314,360,-125,-79,0.4512338908970227,0.4327388910646911,0.1160272180382865,0.4541480915163238,0.4397441875321749,0.10610772095150098,1,0,1,1,2,1,0
314,220,293,-94,-21,0.4060873128216775,0.4660101407256837,0.12790254645263868,0.431985151062929,0.4559429067905874,0.11207194214648344,0,0,1,1,0,1,0
269,63,246,-206,-23,0.45032385826993465,0.42957382109186,0.12010232063820529,0.4643298735684074,0.4223174805456035,0.11335264588598921,1,0,1,2,2,1,0
285,302,379,17,94,0.5437205103155838,0.3413245354496816,0.11495495423473466,0.45990543942111733,0.41463558976686066,0.1254589708120222,1,0,1,1,2,0,1
316,361,377,45,61,0.3451814246298732,0.5251389886883644,0.12967958668176213,0.3470060398666657,0.5384133969439869,0.11458056318934698,1,0,1,1,2,0,1
342,20,228,-322,-114,0.2551593862523542,0.6363056679667956,0.10853494578085017,0.39633806968927104,0.4979892152637739,0.10567271504695493,0,1,1,1,1,1,0
310,219,280,-91,-30,0.2011022246943588,0.6672204929164051,0.131677282389236,0.32074569289673205,0.5711270462986289,0.10812726080463907,1,0,2,3,2,1,0
296,260,273,-36,-23,0.39351333141624173,0.4942907480805608,0.1121959205031974,0.41851534747458685,0.4686074040174305,0.11287724850798261,0,0,1,3,0,1,0
351,276,341,-75,-10,0.47380580305972714,0.42530004295196544,0.10089415398830746,0.4819336539148707,0.40073830136857025,0.11732804471655867,0,0,1,2,0,1,0
494,181,247,-313,-247,0.5363242131295768,0.3464863160285785,0.11718947084184451,0.4736081117884262,0.4108046193553229,0.11558726885625073,1,0,1,1,3,1,0
370,320,337,-50,-33,0.41205546324788545,0.4523609581789553,0.13558357857315917,0.5421650456910931,0.3397689445343515,0.1180660097745554,1,1,1,1,4,1,0
229,241,357,12,128,0.5676612024869647,0.3350184870768377,0.09732031043619782,0.4531182141910044,0.4297733544616561,0.11710843134733959,1,1,1,1,4,0,1
374,307,351,-67,-23,0.4313874377648469,0.45390229829757933,0.11471026393757361,0.4471166280765911,0.43798724127975486,0.11489613064365407,1,0,1,3,3,1,0
317,247,261,-70,-56,0.42090225572570117,0.4684126873800572,0.11068505689424167,0.5091764951372222,0.37625281199167543,0.11457069287110229,0,1,3,1,1,1,0
354,333,367,-21,13,0.49521726518972886,0.40536498109964114,0.09941775371062997,0.4253004660273679,0.4633199739335286,0.11137956003910349,1,1,1,1,4,0,0
409,353,367,-56,-42,0.4806536439298503,0.4021771439629594,0.1171692121071901,0.3848106554870564,0.5030381890394251,0.11215115547351842,1,1,1,1,4,1,0
278,195,248,-83,-30,0.3648225878831142,0.5195323302503451,0.11564508186654057,0.45626044444879194,0.429059464198244,0.11468009135296425,1,0,1,2,3,1,0
312,255,286,-57,-26,0.5046185379764574,0.38497618019578195,0.1104052818277609,0.4447960869387069,0.44200887108444425,0.11319504197684871,0,1,4,1,1,1,0
413,588,616,175,203,0.3393105503204692,0.5207429053658935,0.1399465443136375,0.41320902997127135,0.4770796648054123,0.10971130522331618,1,0,1,2,2,0,1
306,413,503,107,197,0.3655546937592705,0.5034909805785136,0.1309543256622158,0.45134527447182604,0.4370197806693878,0.11163494485878606,1,0,1,2,2,0,1
300,219,280,-81,-20,0.3940836071372466,0.47252058899067145,0.1333958038720819,0.43630370888038167,0.4511492558829775,0.11254703523664052,1,0,1,1,2,1,0
386,315,343,-71,-43,0.2127524322149244,0.6798306370190474,0.10741693076602804,0.3514300443719699,0.5363826756546061,0.11218727997342423,1,1,2,1,4,1,0
425,281,296,-144,-129,0.3785038299835998,0.5062528186140071,0.11524335140239331,0.378880151963148,0.5118693966231735,0.10925045141367846,0,0,2,2,0,1,0
305,264,273,-41,-32,0.39398328027806345,0.4945960956410085,0.11142062408092793,0.46522751582880034,0.4227369793193241,0.11203550485187562,1,1,1,2,4,1,0
388,263,432,-125,44,0.45386049566320663,0.418253408818018,0.12788609551877547,0.403510839493482,0.4867979077218554,0.10969125278466253,1,0,5,3,2,0,0
424,371,401,-53,-23,0.5218795691754049,0.36412642268221673,0.11399400814237842,0.448068695668645,0.43841180028804755,0.11351950404330738,1,0,3,2,2,1,0
309,182,208,-127,-101,0.3984089187677076,0.47756417911385474,0.12402690211843762,0.439932928448031,0.4509609321985015,0.10910613935346755,0,0,1,1,0,1,0
406,260,358,-146,-48,0.3476281430968288,0.530300532115991,0.12207132478718023,0.41671229507776997,0.4745451376611018,0.10874256726112837,0,0,1,3,0,1,0
304,157,275,-147,-29,0.42125839812035376,0.4290288213277244,0.14971278055192153,0.460488463649296,0.4260905487357203,0.11342098761498356,1,0,1,2,2,1,0
308,8,198,-300,-110,0.4606113874368247,0.41311035841325194,0.12627825414992327,0.3836998332159856,0.5050461501094871,0.11125401667452722,1,1,1,2,4,1,0
238,201,222,-37,-16,0.4329571455797062,0.45284860234662305,0.11419425207367077,0.4246560588776674,0.46265437162940276,0.11268956949292981,0,0,1,2,0,1,0
315,506,601,191,286,0.42760332799456513,0.4360265250336903,0.13637014697174432,0.4846220726625324,0.4038726046002417,0.11150532273722596,1,0,3,1,2,0,1
475,285,451,-190,-24,0.2896440307549375,0.5905485453935502,0.11980742385151233,0.4355698532852665,0.4259786136252089,0.13845153308952454,0,0,1,1,0,1,0
556,517,654,-39,98,0.3296134361965211,0.5509353440424404,0.11945121976103842,0.5394387825642409,0.33648003933460535,0.12408117810115377,1,0,1,1,2,0,0
261,133,192,-128,-69,0.4783725081224217,0.4180032709181067,0.10362422095947124,0.5421413086767803,0.34278798516706815,0.11507070615615131,1,0,4,1,2,1,0
752,640,697,-112,-55,0.3356275588780667,0.5171597892274505,0.14721265189448274,0.31687259203716045,0.5690911552672283,0.11403625269561092,0,0,1,5,0,1,0
287,242,259,-45,-28,0.5278748693866999,0.3742915495018437,0.09783358111145636,0.46472087522828187,0.42479687252351694,0.11048225224820107,0,0,2,1,0,1,0
341,312,355,-29,14,0.4271820440048978,0.4565878581690521,0.11623009782604997,0.5433644174851158,0.3414921331568612,0.11514344935802291,1,1,1,3,4,0,0
302,264,288,-38,-14,0.4935658053770646,0.38567203416098683,0.12076216046194839,0.46055633545795643,0.43006412551548845,0.1093795390265552,1,0,1,2,2,1,0
282,43,151,-239,-131,0.5046185379764574,0.38497618019578195,0.1104052818277609,0.4447960869387069,0.44200887108444425,0.11319504197684871,0,0,1,1,0,1,0
369,275,354,-94,-15,0.40330008392703565,0.4848002802928058,0.11189963578015864,0.358323611097949,0.531225398674848,0.11045099022720305,1,0,2,2,2,1,0
395,253,311,-142,-84,0.369348761042713,0.5235141261063745,0.10713711285091236,0.43000902547487174,0.4580802286738247,0.11191074585130334,1,0,2,1,2,1,0
359,266,353,-93,-6,0.436445758119444,0.42462733731355756,0.13892690456699855,0.4613455435375067,0.41056471864339994,0.12808973781909333,1,0,1,2,2,1,0
296,110,173,-186,-123,0.31633826775352225,0.46885619351852975,0.21480553872794772,0.4251580229512344,0.455068181674429,0.1197737953743363,0,0,1,2,0,1,0
315,299,308,-16,-7,0.3534123537315174,0.49567145587635547,0.1509161903921272,0.45368443050982826,0.4212697164940328,0.12504585299613913,0,0,3,1,0,1,0
358,300,321,-58,-37,0.41095214405139713,0.47883062602262433,0.11021722992597877,0.37564156496607665,0.5115842448566874,0.11277419017723636,0,0,1,2,0,1,0
319,219,298,-100,-21,0.3441912111935476,0.530404871480936,0.12540391732551653,0.46401193966860393,0.4240853621369501,0.11190269819444619,0,0,1,1,0,1,0
353,184,387,-169,34,0.33077269505818524,0.5611616458611638,0.10806565908065105,0.3972452122314432,0.49087841487832246,0.11187637289023421,1,1,1,1,4,0,0
336,228,301,-108,-35,0.4470898232973797,0.4036733047142453,0.14923687198837474,0.43655980232586045,0.45315576820306885,0.11028442947107062,0,0,2,1,0,1,0
305,187,250,-118,-55,0.357962472051519,0.5234446651708516,0.11859286277762959,0.469438136896195,0.42277141674543794,0.10779044635836711,0,1,2,1,1,1,0
396,260,356,-136,-40,0.3692649914662434,0.5005293381367976,0.13020567039695888,0.39789623285686465,0.48904541420910264,0.11305835293403245,1,0,2,1,2,1,0
647,505,687,-142,40,0.443252580401885,0.4427072308146125,0.11404018878350267,0.4651768418084914,0.39039212189192146,0.144431036299587,1,0,2,3,2,0,0
429,366,387,-63,-42,0.5397869395911444,0.35826198166340106,0.1019510787454545,0.527086286906757,0.3537316055597225,0.11918210753352028,0,0,2,3,0,1,0
325,340,512,15,187,0.47003611939693374,0.41882802134499997,0.11113585925806643,0.4555664452364932,0.43143483317909204,0.11299872158441486,1,1,2,1,4,0,1
379,295,361,-84,-18,0.40034144525067833,0.4818194280228459,0.11783912672647552,0.5437417527534637,0.3422617898763781,0.11399645737015798,1,0,3,2,3,1,0
326,242,276,-84,-50,0.3983586080072199,0.48423686552988937,0.11740452646289064,0.47704971148159137,0.40105240488454347,0.12189788363386538,0,0,1,2,0,1,0
270,201,228,-69,-42,0.40721187244142504,0.47505173906021086,0.11773638849836385,0.4546968379639789,0.43500181825442485,0.11030134378159617,1,0,1,1,2,1,0
342,293,357,-49,15,0.3620823540155172,0.5168491767875403,0.12106846919694227,0.3864870388499692,0.5022326467198449,0.11128031443018602,1,0,1,2,2,0,0
410,173,236,-237,-174,0.4831205362285823,0.40383954441678654,0.11303991935463102,0.5431359452927327,0.3446435850627918,0.11222046964447531,0,0,1,1,0,1,0
316,269,337,-47,21,0.37791911763495234,0.4934667147392598,0.12861416762578765,0.3594018108926006,0.5332403991876519,0.1073577899197478,0,0,3,3,0,0,0
309,142,257,-167,-52,0.4975478327356382,0.39254084962431796,0.10991131764004394,0.46758816986754426,0.41849718001924374,0.11391465011321203,1,1,1,1,4,1,0
333,256,320,-77,-13,0.5151786940898758,0.3465767998916621,0.13824450601846172,0.6130420799067076,0.2692264758319635,0.11773144426132894,0,1,2,1,1,1,0
533,455,480,-78,-53,0.3575070807811168,0.5368345832955699,0.10565833592331358,0.5327819971361673,0.3528034815324914,0.11441452133134133,1,0,1,3,2,1,0
368,227,309,-141,-59,0.4736941113434333,0.42476401145115317,0.10154187720541366,0.4977076368786043,0.383525811910135,0.11876655121126095,0,0,1,1,0,1,0
280,311,338,31,58,0.2975335135044844,0.5798830433540826,0.12258344314143299,0.49151102561990145,0.38902893122620374,0.11946004315389476,1,0,2,1,2,0,1
216,73,87,-143,-129,0.5074834312213794,0.3987754095046678,0.09374115927395288,0.45753296949187966,0.4293220026818447,0.1131450278262755,1,1,1,2,4,1,0
270,46,229,-224,-41,0.4573014495563122,0.4290439115584584,0.11365463888522939,0.461451152642303,0.4185163400170738,0.12003250734062339,1,1,1,1,4,1,0
282,342,394,60,112,0.47827639151780066,0.3920990160498413,0.12962459243235794,0.4923061332601248,0.3957448243598952,0.11194904237997984,1,0,1,4,2,0,1
357,233,372,-124,15,0.40652760093378665,0.4674583407980448,0.1260140582681684,0.5280593864088635,0.36200255176226553,0.1099380618288707,1,0,1,1,2,0,0
259,158,213,-101,-46,0.4245012329143996,0.4667018840538515,0.10879688303174903,0.4708913098870715,0.41556718631058803,0.1135415038023406,0,0,1,1,0,1,0
295,205,242,-90,-53,0.4930014944739409,0.3750621959078809,0.13193630961817826,0.48511370145817145,0.3983110222366437,0.11657527630518472,0,0,1,2,0,1,0
304,240,283,-64,-21,0.4726803826382115,0.42318448736204206,0.10413512999974643,0.4041082999789051,0.48380568362343684,0.11208601639765797,0,1,1,1,1,1,0
275,223,247,-52,-28,0.44409626816623055,0.44023033996834915,0.11567339186542022,0.44798738217466333,0.4427777101450544,0.10923490768028213,1,0,2,3,2,1,0
418,301,449,-117,31,0.39938488827240476,0.4598195277306654,0.14079558399692985,0.47580200128635985,0.4130400507687003,0.11115794794493986,1,1,2,3,4,0,0
330,190,215,-140,-115,0.4002570310443174,0.48068573368072276,0.1190572352749601,0.4533908681554686,0.4291816878878494,0.11742744395668207,1,0,1,1,2,1,0
298,316,329,18,31,0.41359900820999396,0.46494641367835876,0.12145457811164732,0.4187889111931862,0.4703477237601244,0.11086336504668909,1,0,1,1,2,0,1
322,273,288,-49,-34,0.5046185379764574,0.38497618019578195,0.1104052818277609,0.4447960869387069,0.44200887108444425,0.11319504197684871,1,0,1,1,2,1,0
505,375,483,-130,-22,0.48016312692224056,0.3849303134512484,0.13490655962651094,0.47156181554658266,0.4135690433135404,0.11486914113987691,1,0,2,1,3,1,0
333,309,410,-24,77,0.4316963394383194,0.44594137443667814,0.1223622861250026,0.44140422722814954,0.4500476242716431,0.1085481485002072,1,0,1,3,2,0,0
306,459,586,153,280,0.3938684941827677,0.48109871159812445,0.12503279421910782,0.3780436809801017,0.5113701847066848,0.11058613431321321,1,0,1,3,2,0,1
382,263,309,-119,-73,0.4991802945509701,0.4025480069656562,0.09827169848337373,0.4066200164327112,0.4813940132192681,0.11198597034802085,0,0,1,2,0,1,0
117,0,233,-117,116,0.486951083889689,0.41095906751890815,0.10208984859140321,0.46809730831411733,0.41854779424174554,0.11335489744413679,1,1,1,1,4,0,0
534,419,455,-115,-79,0.34014895728834565,0.5365826237563035,0.12326841895535103,0.33718518129250685,0.5523402254662233,0.11047459324126978,1,0,1,2,2,1,0
354,141,247,-213,-107,0.42178364777395355,0.45274749607024345,0.12546885615580278,0.3970575231100185,0.49048565066769934,0.1124568262222822,1,1,1,2,4,1,0
354,229,271,-125,-83,0.4682886499697398,0.4213885730325276,0.11032277699773271,0.40675678740512067,0.48430882954794363,0.10893438304693599,0,1,1,1,1,1,0
314,191,385,-123,71,0.4376802778021504,0.4244259034963098,0.13789381870153974,0.4794745266109598,0.4083007833880881,0.11222469000095206,1,0,1,2,2,0,0
253,182,190,-71,-63,0.4732643810014117,0.406182319478902,0.12055329951968655,0.4020753622168225,0.48544892141512824,0.11247571636804914,1,0,1,1,2,1,0
376,174,213,-202,-163,0.33692840856248757,0.527891845667412,0.13517974577010022,0.5353202772453598,0.34642452758589987,0.11825519516874038,0,0,2,2,0,1,0
369,237,269,-132,-100,0.48336826922774884,0.41901559445074565,0.09761613632150572,0.5357471656641565,0.34218285784651664,0.12206997648932709,0,0,1,1,0,1,0
400,331,347,-69,-53,0.4721675587351617,0.41281710720221787,0.11501533406262081,0.4973951221253372,0.3912726455156921,0.11133223235897047,0,0,1,1,0,1,0
289,216,262,-73,-27,0.46471145210510845,0.39742312404497576,0.13786542384991562,0.4451501516703711,0.4362439120303131,0.11860593629931576,1,0,1,1,3,1,0
297,206,264,-91,-33,0.39257629799110494,0.48710431882130945,0.12031938318758545,0.4716540652871786,0.41674659658229646,0.11159933813052522,1,1,1,1,4,1,0
362,292,338,-70,-24,0.4515056666164477,0.4289721457449651,0.11952218763858727,0.4425897445155392,0.43801947665325563,0.11939077883120523,1,1,1,1,4,1,0
323,177,258,-146,-65,0.46037904774209293,0.43725248798795174,0.10236846426995536,0.5492889120927297,0.32925482241490694,0.12145626549236321,0,1,1,1,1,1,0
343,360,441,17,98,0.42859488317802147,0.44280593632419185,0.1285991804977868,0.5452789303672716,0.3401748687960531,0.11454620083667516,1,1,1,1,4,0,1
433,344,387,-89,-46,0.4343851056324505,0.442921030811832,0.12269386355571762,0.44674556187412,0.44284988356345084,0.11040455456242895,1,0,2,2,3,1,0
351,260,390,-91,39,0.36643716362078244,0.49974278050506604,0.13382005587415152,0.4977857987531554,0.3837061855762088,0.11850801567063575,1,0,1,1,2,0,0
256,164,232,-92,-24,0.5064817367532275,0.39280568361352713,0.10071257963324523,0.41133144981831843,0.4745616562662103,0.11410689391547134,0,0,1,4,0,1,0
356,298,312,-58,-44,0.40448818727790714,0.47776385724746984,0.11774795547462305,0.44689393500938696,0.4390166310761262,0.11408943391448671,1,0,2,1,2,1,0
311,232,279,-79,-32,0.4836095820868928,0.4083656267536343,0.10802479115947278,0.47438535783243807,0.40816804538762147,0.11744659677994021,1,0,1,1,3,1,0
352,229,297,-123,-55,0.3450014696286084,0.5411597491139886,0.11383878125740274,0.47509575499164913,0.4078553286965678,0.11704891631178291,1,1,1,1,4,1,0
282,321,349,39,67,0.43017159271781674,0.44049514581220545,0.12933326146997773,0.40768431710101305,0.47887215092381863,0.11344353197516847,1,0,1,1,2,0,1
345,0,36,-345,-309,0.5080063050792774,0.3737050576252625,0.11828863729546005,0.4443256310517227,0.44184011527131073,0.11383425367696653,1,1,1,1,4,1,0
282,201,235,-81,-47,0.383999366994434,0.4798726221161142,0.13612801088945176,0.35165287077617474,0.5381671602767141,0.11017996894711127,0,0,1,3,0,1,0
326,243,262,-83,-64,0.4802408849071449,0.4149363143504897,0.10482280074236534,0.4893103657937358,0.3946471732358677,0.11604246097039661,1,0,1,1,2,1,0
321,224,276,-97,-45,0.4538946389127355,0.4236619025172281,0.1224434585700366,0.4454904215339939,0.4278400468328228,0.1266695316331832,1,1,2,1,4,1,0
280,170,197,-110,-83,0.5272533836104063,0.3565522097549377,0.11619440663465613,0.5315577555176959,0.3552423209650123,0.11319992351729187,0,0,2,4,0,1,0
183,108,145,-75,-38,0.5160818965723809,0.37725476183344053,0.10666334159417837,0.4831417300071371,0.396839018594277,0.12001925139858602,0,1,2,1,1,1,0
290,277,305,-13,15,0.48447978885047677,0.40713393498185385,0.10838627616766962,0.4905643230921347,0.3976503922322638,0.11178528467560163,1,0,2,1,2,0,0
529,402,468,-127,-61,0.43271743414322555,0.4481811184657691,0.11910144739100563,0.3644544998180544,0.5221110932704748,0.11343440691147047,0,0,1,1,0,1,0
322,345,398,23,76,0.4634250118580753,0.4134574769918479,0.12311751115007695,0.5123314415418067,0.37023381190899035,0.117434746549203,0,0,2,2,0,0,1
276,290,319,14,43,0.3299033989313139,0.5351451407863161,0.1349514602823701,0.3845932243521579,0.48865878650810596,0.12674798913973595,1,0,1,2,2,0,1
271,216,243,-55,-28,0.5046185379764574,0.38497618019578195,0.1104052818277609,0.4447960869387069,0.44200887108444425,0.11319504197684871,1,0,1,3,2,1,0
329,361,381,32,52,0.47252717836810676,0.42630227112500246,0.1011705505068907,0.37271587788644484,0.5126441671757537,0.1146399549378014,1,0,2,1,2,0,1
343,289,312,-54,-31,0.3620844886087859,0.52964908015864,0.1082664312325738,0.4095837245635374,0.4785996639724761,0.11181661146398636,1,0,1,4,3,1,0
308,367,418,59,110,0.46099862967574934,0.4150132349465974,0.12398813537765313,0.4590829586415172,0.4155816044607101,0.1253354368977725,1,0,1,1,2,0,1
383,285,365,-98,-18,0.3259257808060702,0.5459278074078677,0.12814641178606231,0.5433797512383619,0.3373908408619914,0.11922940789964674,0,0,2,1,0,1,0
446,456,539,10,93,0.38990303290114975,0.48637725036174095,0.12371971673710937,0.43803055368882293,0.4493223029578147,0.11264714335336255,1,0,3,1,2,0,1
297,211,248,-86,-49,0.36306479469482683,0.5273135407846901,0.1096216645204829,0.36884915279927305,0.5198323420222148,0.11131850517851191,1,1,1,1,4,1,0
304,76,114,-228,-190,0.47711489422672754,0.4063734220638019,0.11651168370947046,0.4206940710417171,0.46803986056742547,0.11126606839085731,1,1,1,1,4,1,0
470,319,507,-151,37,0.504402613816431,0.38121721022436056,0.11438017595920816,0.5069204682652041,0.3753207383872622,0.11775879334753378,1,0,2,2,2,0,0
243,135,191,-108,-52,0.40779528113975083,0.4566490070418387,0.1355557118184107,0.4191081770610341,0.46024529248671087,0.12064653045225512,0,0,2,1,0,1,0
266,236,245,-30,-21,0.4431008149100373,0.454474379840757,0.10242480524920572,0.4310741631603685,0.45763797633850223,0.11128786050112906,1,0,3,4,2,1,0
277,193,238,-84,-39,0.45252933271180135,0.43985498487399893,0.10761568241419955,0.43335024424796703,0.45642241208830203,0.11022734366373109,1,0,1,1,3,1,0
307,236,259,-71,-48,0.24469542932870383,0.6229203219047467,0.13238424876654964,0.4404028678125993,0.4423819550576213,0.11721517712977951,1,0,1,1,2,1,0
474,314,414,-160,-60,0.410217244569236,0.4613740398822289,0.12840871554853509,0.4080227327348088,0.48383357210414674,0.10814369516104434,0,0,3,1,0,1,0
229,234,320,5,91,0.4564268842151195,0.4250123274961974,0.11856078828868327,0.4633349817105857,0.42276567788649566,0.1138993404029187,1,1,1,1,4,0,1
283,311,383,28,100,0.4866908722216215,0.40217545731855303,0.11113367045982557,0.4527283526966245,0.43327712781673144,0.1139945194866441,1,0,3,1,2,0,1
327,236,313,-91,-14,0.4917087332043846,0.40177233679548463,0.10651893000013093,0.4422965655905952,0.44550027336897974,0.11220316104042502,1,0,1,1,2,1,0
357,102,287,-255,-70,0.4554300549195852,0.43471319337679115,0.1098567517036235,0.5360540313497556,0.34713460581921485,0.11681136283102941,0,0,1,2,0,1,0
228,162,203,-66,-25,0.5022480389921017,0.37989768669657153,0.11785427431132674,0.44936804718151613,0.4388657977023451,0.11176615511613908,1,0,1,1,2,1,0
274,220,243,-54,-31,0.5277623130949902,0.3594691581781812,0.11276852872682876,0.4118824034609774,0.4765298042488556,0.11158779229016688,1,0,1,1,3,1,0
254,318,391,64,137,0.4975413451922146,0.39448885846604426,0.10796979634174117,0.4361254854725724,0.44980038958572416,0.1140741249417035,0,0,1,1,0,0,1
260,221,305,-39,45,0.522594415062828,0.3736740549038735,0.10373153003329852,0.5043821224411675,0.3825052290736418,0.11311264848519083,1,1,1,1,4,0,0
308,242,260,-66,-48,0.4395370294126909,0.42660758575514557,0.13385538483216342,0.341256860552177,0.5492358607508565,0.1095072786969664,1,0,1,3,2,1,0
345,293,321,-52,-24,0.5865062099873726,0.30698219264766136,0.10651159736496586,0.47651922723218937,0.41432443802036817,0.10915633474744253,0,0,2,1,0,1,0
466,392,480,-74,14,0.29358741730787724,0.5832097869447336,0.123202795747389,0.4185310654046544,0.4681976874675299,0.1132712471278154,1,0,2,1,2,0,0
343,394,447,51,104,0.42997321586706,0.43095815538261134,0.13906862875032877,0.37541281635711354,0.5028512014110542,0.12173598223183246,1,0,1,1,2,0,1
395,323,371,-72,-24,0.48249272825420436,0.3982930925849832,0.11921417916081206,0.2993670018456366,0.5866987952737313,0.11393420288063193,1,1,1,3,4,1,0
341,203,244,-138,-97,0.35177769233594525,0.5133042282615944,0.13491807940246042,0.431110003322855,0.45711712805679344,0.1117728686203517,1,1,1,1,4,1,0
413,351,380,-62,-33,0.39384085094268306,0.49897512024056084,0.1071840288167561,0.48616976911567017,0.3999933168085016,0.11383691407582856,1,0,1,1,2,1,0
417,289,318,-128,-99,0.36920657667336726,0.48328166793183014,0.14751175539480274,0.5123777604796492,0.37139028098879107,0.1162319585315595,0,0,3,1,0,1,0
360,250,282,-110,-78,0.6354297750887761,0.2794602833174354,0.08510994159378858,0.5420885663856261,0.34489999763113216,0.11301143598324181,0,1,3,1,1,1,0
229,107,254,-122,25,0.41355488995556816,0.47876591381096123,0.10767919623347076,0.44603359409855986,0.44206715422225734,0.11189925167918316,1,0,1,2,2,0,0
275,204,233,-71,-42,0.38026656372639994,0.5032832114373837,0.1164502248362163,0.4247679226924943,0.462856625477061,0.11237545183044484,0,0,2,2,0,1,0
354,273,308,-81,-46,0.3825024633029865,0.4727153715594073,0.14478216513760625,0.4027008293499685,0.48474251320862255,0.11255665744140893,1,0,1,3,2,1,0
261,178,200,-83,-61,0.4997130045280608,0.3996430555907939,0.10064393988114534,0.4718851116914884,0.4145640323367372,0.11355085597177446,1,0,1,1,2,1,0
305,333,373,28,68,0.3759647942492551,0.5054734717899383,0.11856173396080663,0.36374346938693736,0.5261799698498842,0.11007656076317873,0,0,2,2,0,0,1
462,271,419,-191,-43,0.4468459804820036,0.43156497574077357,0.1215890437772228,0.5270755849055937,0.3587385112975992,0.11418590379680701,0,1,2,1,1,1,0
349,292,333,-57,-16,0.41740997983586015,0.45605418283815485,0.12653583732598517,0.5272899845976063,0.3575728791341471,0.11513713626824668,1,1,2,1,4,1,0
389,191,270,-198,-119,0.43909452966474527,0.43893134245239473,0.12197412788286,0.358531541675082,0.5328425330779377,0.10862592524698006,1,0,2,2,3,1,0
266,60,283,-206,17,0.3656013603109031,0.4915065594943919,0.1428920801947051,0.43838720781817436,0.4434585821886773,0.11815420999314824,1,0,1,1,2,0,0
256,202,220,-54,-36,0.4454945012129088,0.43893147844114716,0.11557402034594391,0.48269661712457057,0.4028375820235628,0.11446580085186676,0,0,2,1,0,1,0
413,359,386,-54,-27,0.3214646310658845,0.5752155328137437,0.10331983612037193,0.3634344986886352,0.5233371401171246,0.11322836119424033,1,1,3,1,4,1,0
382,346,367,-36,-15,0.41355017661444915,0.45853034102039203,0.12791948236515882,0.500100022393849,0.3867972009472463,0.1131027766589046,1,0,2,1,2,1,0
296,257,282,-39,-14,0.3867695511112583,0.4758404801236155,0.13738996876512605,0.4927577027368865,0.3962434001796579,0.11099889708345571,1,0,1,3,2,1,0
341,242,263,-99,-78,0.36707530125069593,0.5267274927106583,0.10619720603864534,0.49014660447346536,0.39712460806735084,0.11272878745918376,1,1,2,1,4,1,0
443,327,370,-116,-73,0.49170340519557143,0.3984908063208053,0.10980578848362309,0.42912226661460656,0.4580315320404909,0.11284620134490259,0,0,2,1,0,1,0
372,244,454,-128,82,0.49104244598138774,0.39503727064504857,0.1139202833735636,0.5140480090746193,0.375841070739452,0.11011092018592872,0,0,2,1,0,0,0
271,186,215,-85,-56,0.4293547406190313,0.4562744034459313,0.11437085593503746,0.41363078891279276,0.47553831317138756,0.1108308979158198,1,0,3,1,2,1,0
566,259,432,-307,-134,0.33212653121697505,0.5559759290487306,0.11189753973429417,0.5446622057561167,0.34429082565003716,0.11104696859384608,1,0,2,1,2,1,0
289,223,264,-66,-25,0.3780148414041673,0.5113264179886359,0.11065874060719647,0.3438479913772079,0.5426031549185512,0.11354885370424107,1,1,1,1,4,1,0
373,394,419,21,46,0.5374654262509668,0.3507750059197928,0.11175956782924043,0.47049623198955765,0.4107440641734161,0.11875970383702619,1,0,3,1,2,0,1
300,388,472,88,172,0.4451723125532812,0.4422779378330341,0.11254974961368455,0.43168102387661045,0.46034406025798935,0.10797491586540019,1,0,3,4,2,0,1
328,195,284,-133,-44,0.5040066958018629,0.3856307020047863,0.11036260219335121,0.41697178640154503,0.47237004430934215,0.11065816928911261,1,1,2,4,4,1,0
364,273,339,-91,-25,0.3281161900864038,0.5092745443106484,0.16260926560294803,0.4901734070578745,0.3932808628016388,0.1165457301404869,1,0,1,1,2,1,0
176,156,165,-20,-11,0.4429914177964673,0.4274644980376125,0.12954408416592011,0.4361298230087622,0.4527774476533187,0.11109272933791907,1,0,1,2,2,1,0
535,342,472,-193,-63,0.44280357256292735,0.4255852711198586,0.13161115631721393,0.47169534454057327,0.40816261224210715,0.1201420432173195,1,1,1,1,4,1,0
402,298,388,-104,-14,0.3057133060364173,0.5784639301265135,0.11582276383706921,0.4098688890275734,0.4812763032477993,0.10885480772462731,1,1,1,1,4,1,0
384,446,492,62,108,0.46670370401339417,0.416289519433808,0.11700677655279784,0.3820795699438455,0.5073751056188781,0.11054532443727663,1,0,1,2,2,0,1
165,0,91,-165,-74,0.4873164988873804,0.3961636586752673,0.11651984243735257,0.4646244951608377,0.42009626190839583,0.11527924293076672,0,0,1,1,0,1,0
337,360,421,23,84,0.437979416326262,0.4333877425066453,0.1286328411670927,0.3991301989615517,0.47920077935208255,0.12166902168636562,1,0,3,1,2,0,1
245,253,343,8,98,0.432706064207986,0.44672789726501727,0.12056603852699666,0.3976797410265174,0.49166840493687775,0.11065185403660484,0,1,1,2,1,0,1
156,74,174,-82,18,0.46819421040144243,0.41666386526600485,0.11514192433255308,0.46096600730751924,0.42329059862027685,0.11574339407220378,1,1,1,1,4,0,0
215,247,276,32,61,0.2643596439317487,0.5926611521801551,0.14297920388809596,0.44618151360939573,0.43905110722072066,0.11476737916988371,1,0,1,2,2,0,1
446,307,323,-139,-123,0.35757779809195783,0.50367478082769,0.13874742108035226,0.45370801190242593,0.4362651625150025,0.11002682558257158,1,0,1,1,2,1,0
421,245,385,-176,-36,0.24236548414066864,0.6196064233005318,0.13802809255879908,0.440038807774447,0.4479745431240936,0.11198664910145967,1,0,1,1,3,1,0
308,286,333,-22,25,0.25174899572553316,0.6020925200778141,0.1461584841966528,0.3437954847473934,0.5438276886983419,0.11237682655426469,1,0,1,2,2,0,0
601,646,781,45,180,0.3820980207479668,0.5007914053853376,0.11711057386669554,0.5335694649544751,0.34455311387795345,0.12187742116757161,1,0,1,1,2,0,1
282,304,314,22,32,0.3638539599745004,0.4887043765216171,0.14744166350388258,0.4559026964069271,0.41289279930929,0.13120450428378247,0,1,3,2,1,0,1
359,313,341,-46,-18,0.38630293006603666,0.49925716500722805,0.11443990492673535,0.47126041740925284,0.41641288750410077,0.1123266950866463,1,0,4,2,3,1,0
440,322,376,-118,-64,0.3984600064770817,0.46369637952243753,0.13784361400048067,0.5245567194956569,0.35788331794108624,0.11755996256325678,1,0,1,1,2,1,0
102,0,82,-102,-20,0.48115905489399613,0.40338580378300265,0.11545514132300122,0.48407875608617684,0.404403363349447,0.11151788056437617,0,0,1,1,0,1,0
338,253,302,-85,-36,0.4935034204213097,0.40657474384125497,0.09992183573743517,0.39161934809144794,0.4960428853931835,0.1123377665153687,0,0,1,1,0,1,0
331,210,236,-121,-95,0.4642188251859773,0.4134721360351157,0.1223090387789067,0.46467668736542533,0.42458877257737804,0.11073454005719674,1,0,3,3,3,1,0
384,333,367,-51,-17,0.5055124017152514,0.39443673001789875,0.10005086826684977,0.4063505270306783,0.482650370875631,0.11099910209369049,1,0,3,3,2,1,0
387,332,378,-55,-9,0.37581693752927586,0.5078226211504197,0.11636044132030425,0.4620255834277488,0.4174514507057523,0.12052296586649903,1,0,1,2,2,1,0
275,185,231,-90,-44,0.46141308741433185,0.43361609361191006,0.10497081897375843,0.4189377903846241,0.46954858473930416,0.11151362487607194,1,0,1,3,2,1,0
394,202,240,-192,-154,0.4677150522072515,0.39047948299524043,0.141805464797508,0.5369804815965596,0.3410144483605225,0.12200507004291777,1,0,2,1,2,1,0
311,344,529,33,218,0.43118631726241874,0.4556681463056616,0.1131455364319197,0.46714427222800375,0.4195478185245953,0.1133079092474009,1,0,1,1,2,0,1
259,212,239,-47,-20,0.4187381903124424,0.4454217539391591,0.13584005574839828,0.4950629369926352,0.38395385393787634,0.12098320906948835,1,1,1,1,4,1,0
321,379,420,58,99,0.4051429212773863,0.4597014341503284,0.13515564457228516,0.48261533756724556,0.39201122653139897,0.12537343590135572,1,0,1,2,2,0,1
318,193,270,-125,-48,0.4384650946485407,0.44018154042243035,0.12135336492902893,0.43550065505205954,0.4452869280050793,0.11921241694286124,0,0,2,1,0,1,0
350,287,323,-63,-27,0.4339782364884868,0.4634887082999465,0.10253305521156651,0.5321922321233608,0.35226783301098863,0.11553993486565063,1,1,1,1,4,1,0
280,217,239,-63,-41,0.4763802914908416,0.41066554922315035,0.11295415928600798,0.4470330828404937,0.4404020441817325,0.11256487297777373,1,0,1,3,2,1,0
364,275,334,-89,-30,0.36316878687526055,0.5171227045682749,0.11970850855646466,0.4232110635665011,0.4487411360782563,0.12804780035524257,1,0,1,1,2,1,0
478,368,427,-110,-51,0.2682379061481784,0.6105524132770278,0.12120968057479393,0.4562081620884739,0.4208659747134198,0.12292586319810615,1,0,1,1,2,1,0
124,0,245,-124,121,0.4515209651146176,0.4372415214996804,0.11123751338570165,0.46836621827734676,0.41725640367889416,0.11437737804375918,1,0,1,1,2,0,0
342,261,368,-81,26,0.2628698826150826,0.5684613093925823,0.1686688079923353,0.39309041794369026,0.4974255028317836,0.10948407922452602,1,0,2,2,2,0,0
146,0,18,-146,-128,0.5046185379764574,0.38497618019578195,0.1104052818277609,0.4447960869387069,0.44200887108444425,0.11319504197684871,1,1,1,1,4,1,0
223,139,155,-84,-68,0.5058209675837968,0.3926042920778346,0.10157474033836847,0.5363890621952004,0.34946881271971597,0.11414212508508356,0,1,2,1,1,1,0
452,339,503,-113,51,0.3310820221394865,0.5544268903797003,0.11449108748081317,0.4322943145574981,0.45828339712408495,0.1094222883184171,1,0,1,2,2,0,0
302,269,288,-33,-14,0.422046812013663,0.4671121599117215,0.11084102807461581,0.40056380050490054,0.48967942623840666,0.10975677325669288,1,1,4,2,4,1,0
360,401,419,41,59,0.4282355854605734,0.45911444414579977,0.11264997039362688,0.3769422787114825,0.5113894853779438,0.11166823591057358,0,0,1,3,0,0,1
475,312,452,-163,-23,0.37849026016562143,0.5155479660009579,0.10596177383342033,0.48856731695331207,0.39753745597194867,0.11389522707473866,0,1,1,1,1,1,0
360,337,352,-23,-8,0.3823658397187513,0.49644313086026515,0.12119102942098342,0.4495383575559862,0.4350860395719707,0.11537560287204324,0,0,1,1,0,1,0
341,369,427,28,86,0.3529054898399816,0.5469250106396402,0.10016949952037857,0.5203405074349112,0.3631023806292143,0.11655711193587448,0,1,2,1,1,0,1
333,374,394,41,61,0.4413240034435307,0.4647980916118359,0.09387790494463322,0.4772612919548095,0.4110140441196675,0.11172466392552295,1,1,3,1,4,0,1
290,208,230,-82,-60,0.4421258216492538,0.4385366904302232,0.11933748792052319,0.4527672960451527,0.43629030762580273,0.11094239632904446,1,1,2,3,4,1,0
462,363,385,-99,-77,0.44125899272464597,0.44781876224666367,0.11092224502869039,0.4264477834031089,0.45951653196063,0.11403568463626114,1,0,2,1,2,1,0
305,228,276,-77,-29,0.4246161100628664,0.45971997301151285,0.1156639169256207,0.437733213338945,0.4448817758107242,0.11738501085033093,1,0,1,3,2,1,0
298,169,302,-129,4,0.477980467467178,0.3963686596674158,0.12565087286540602,0.5236331387290986,0.3565520120411472,0.11981484922975434,1,0,1,1,2,0,0
278,230,264,-48,-14,0.32468903796932663,0.5692015899453675,0.10610937208530599,0.41174796192699953,0.478306935189006,0.10994510288399449,1,0,1,2,2,1,0
338,232,265,-106,-73,0.48108917949188346,0.4013756287008931,0.11753519180722354,0.4768905873476783,0.41171304191634084,0.11139637073598063,0,0,3,2,0,1,0
358,405,444,47,86,0.4675829236674549,0.4004332189385189,0.13198385739402618,0.4963263040793704,0.3886551667706014,0.11501852915002811,1,0,2,4,2,0,1
350,14,330,-336,-20,0.5046185379764574,0.38497618019578195,0.1104052818277609,0.4447960869387069,0.44200887108444425,0.11319504197684871,0,0,1,1,0,1,0
290,239,269,-51,-21,0.3929955475143605,0.45390100686523255,0.15310344562040706,0.5016477402122533,0.370299785593566,0.12805247419418075,1,1,1,1,4,1,0
403,292,361,-111,-42,0.49986252859737945,0.3756967129401532,0.1244407584624672,0.4709553560087115,0.4115900569818761,0.11745458700941255,1,0,1,2,3,1,0
360,242,425,-118,65,0.464703210615041,0.41760056977706944,0.11769621960788959,0.41152311024109617,0.4772931669515226,0.1111837228073815,1,0,1,1,2,0,0
425,364,410,-61,-15,0.32675969162204804,0.5656785684994032,0.10756173987854889,0.3492705329521354,0.5401205383684438,0.11060892867942071,0,1,1,1,1,1,0
284,0,160,-284,-124,0.5140740415494685,0.3782603855426734,0.107665572907858,0.5076598626379303,0.3798896256864175,0.11245051167565229,0,0,1,1,0,1,0
337,249,265,-88,-72,0.3954093857895813,0.49453255256371276,0.11005806164670613,0.36842290337175837,0.5226283596886258,0.10894873693961608,0,0,1,1,0,1,0
433,444,462,11,29,0.48613459934666053,0.37624299211263895,0.1376224085407002,0.42258870781019653,0.4652687169611574,0.11214257522864589,1,0,1,4,2,0,1
372,478,515,106,143,0.38727463813298124,0.48669728664407746,0.12602807522294115,0.42861250338466506,0.45766561589730836,0.11372188071802666,1,1,3,5,4,0,1
429,440,535,11,106,0.2951130399837182,0.5229330505785544,0.18195390943772755,0.49243037474544743,0.37406560545797013,0.1335040197965824,1,1,1,1,4,0,1
363,264,283,-99,-80,0.5416898277224991,0.3671604636708251,0.09114970860667604,0.5406294300932866,0.349773001416373,0.10959756849034051,0,0,3,1,0,1,0
408,353,380,-55,-28,0.23679098822458852,0.6313889834526567,0.1318200283227546,0.5039095256781121,0.3683907954994939,0.127699678822394,0,0,2,2,0,1,0
338,239,252,-99,-86,0.43240654397334216,0.4555593196837452,0.11203413634291255,0.5384623725348983,0.3439940269238085,0.11754360054129315,0,1,2,1,1,1,0
645,341,622,-304,-23,0.23683689496377866,0.670340606811122,0.09282249822509957,0.5027622783712228,0.3858334599616881,0.1114042616670891,1,0,2,1,2,1,0
318,180,302,-138,-16,0.4488142446361959,0.43401318301322167,0.11717257235058258,0.5003132087544176,0.385259506975809,0.11442728426977354,0,0,1,1,0,1,0
263,330,368,67,105,0.3593488332023303,0.5138225780164918,0.12682858878117792,0.4213174297473673,0.45369682142632456,0.12498574882630772,0,0,1,1,0,0,1
291,311,358,20,67,0.3842223083131298,0.4969240032376062,0.11885368844926374,0.41115046297258434,0.46654865093168635,0.12230088609572928,0,0,3,1,0,0,1
420,351,374,-69,-46,0.19910785858866512,0.6578822977081137,0.14300984370322126,0.47647257709459934,0.4036843140092789,0.11984310889612158,1,1,1,2,4,1,0
338,267,307,-71,-31,0.45800401829122384,0.4316151317897509,0.11038084991902523,0.4439834460363186,0.44391214897054077,0.11210440499314045,0,0,1,1,0,1,0
241,179,200,-62,-41,0.4381568709151182,0.4532169663266462,0.10862616275823578,0.43465437255058215,0.45248000468563426,0.11286562276378367,0,0,2,3,0,1,0
203,211,246,8,43,0.4115670165455706,0.48235716674677,0.10607581670765942,0.4378665104309982,0.44985434443414546,0.11227914513485622,0,0,2,2,0,0,1
241,151,193,-90,-48,0.43427357342003137,0.4483974647907028,0.11732896178926558,0.46859245668849525,0.4139248221518175,0.11748272115968704,0,1,1,1,1,1,0
376,318,330,-58,-46,0.4647159957685014,0.41218999598149475,0.12309400825000377,0.4234019201698937,0.46649600457471174,0.11010207525539462,1,0,3,2,3,1,0
238,185,201,-53,-37,0.4078921739645645,0.47187780269045604,0.12023002334497947,0.46538735201986947,0.42263686380720694,0.11197578417292398,1,0,2,3,2,1,0
416,227,310,-189,-106,0.437461998163321,0.4260710414060417,0.1364669604306372,0.45868022484989124,0.4284470494377331,0.11287272571237575,1,0,1,1,2,1,0
338,214,278,-124,-60,0.3571288750386582,0.5420307836345581,0.10084034132678375,0.4907537827378428,0.3852741627335864,0.1239720545285704,1,1,3,1,4,1,0
270,172,363,-98,93,0.47621338718816053,0.40692300914454815,0.11686360366729143,0.40791934723031514,0.4805160100592813,0.11156464271040359,0,1,2,1,1,0,0
64,0,28,-64,-36,0.5046185379764574,0.38497618019578195,0.1104052818277609,0.4447960869387069,0.44200887108444425,0.11319504197684871,1,0,1,1,2,1,0
539,488,506,-51,-33,0.3230962097286464,0.5372595122721588,0.1396442779991944,0.34497974872021625,0.5427001140524198,0.11232013722736407,1,0,1,2,2,1,0
285,110,160,-175,-125,0.4058940088630115,0.4428987498138667,0.15120724132312194,0.4266119345342569,0.46102498939495823,0.11236307607078475,0,1,2,2,1,1,0
289,126,311,-163,22,0.5206516998476537,0.3803481596726321,0.09900014047971425,0.5123859201329048,0.370477532422723,0.11713654744437221,0,0,1,1,0,0,0
292,215,223,-77,-69,0.2789223894122661,0.6139610273338801,0.1071165832538537,0.45236323453485305,0.4340132496264919,0.11362351583865501,0,1,1,2,1,1,0
241,163,230,-78,-11,0.33247193701838523,0.5134963819965954,0.15403168098501924,0.4041568852305052,0.48468500981616436,0.11115810495333066,1,0,1,3,2,1,0
288,237,266,-51,-22,0.48736697918421173,0.4118999659593736,0.10073305485641476,0.40959210957835546,0.4792582370458372,0.11114965337580765,1,1,1,2,4,1,0
425,481,580,56,155,0.4237730337047268,0.42911237525653767,0.14711459103873573,0.41857699249958774,0.4540366846917351,0.12738632280867723,1,0,4,1,2,0,1
440,348,472,-92,32,0.35663927694789493,0.5271173065354614,0.11624341651664377,0.31851952305642245,0.5685381717035297,0.11294230524004802,1,1,1,1,4,0,0
253,290,335,37,82,0.40792008314156203,0.48166744304989423,0.1104124738085438,0.44621865375353675,0.4392021259077564,0.11457922033870674,1,0,3,1,2,0,1
324,199,225,-125,-99,0.4661741385997444,0.41414232955299046,0.11968353184726524,0.4819928099175991,0.4049474285804682,0.11305976150193248,0,0,2,1,0,1,0
206,261,311,55,105,0.435227476401006,0.45489799316060225,0.10987453043839177,0.4748213231812366,0.4146711363325516,0.11050754048621161,1,0,1,3,2,0,1
319,261,287,-58,-32,0.3749444328193555,0.48824316650872696,0.1368124006719177,0.443179548549555,0.4440277334365071,0.11279271801393792,1,1,5,1,4,1,0
463,355,403,-108,-60,0.3677806572470351,0.48008100873937537,0.15213833401358945,0.45029158529326613,0.44078719998427135,0.10892121472246266,0,0,1,1,0,1,0
439,254,320,-185,-119,0.2951929927904474,0.5738774980843968,0.13092950912515544,0.5611626496014248,0.3017122933098353,0.13712505708873965,1,1,1,1,4,1,0
324,35,83,-289,-241,0.5046185379764574,0.38497618019578195,0.1104052818277609,0.4447960869387069,0.44200887108444425,0.11319504197684871,1,0,1,1,2,1,0
270,286,312,16,42,0.5116107526112987,0.3905479750159338,0.09784127237276741,0.4871940640776456,0.39808485357083484,0.11472108235151941,1,0,1,1,2,0,1
336,191,289,-145,-47,0.4683111447068957,0.4379343190266444,0.09375453626645965,0.5438665650985155,0.3408480369287045,0.11528539797277991,0,0,3,1,0,1,0
289,239,272,-50,-17,0.3923723855751867,0.49164947536927606,0.11597813905553715,0.4507691025578245,0.4309852455242378,0.11824565191793761,0,0,2,3,0,1,0
384,400,438,16,54,0.323755877019658,0.5637005063210133,0.11254361665932883,0.42573996947561904,0.46229739690651883,0.11196263361786217,1,0,1,2,2,0,1
355,266,368,-89,13,0.4843626176749955,0.3808998068870918,0.13473757543791257,0.41959949510812583,0.46934032088522126,0.11106018400665314,1,0,1,1,2,0,0
451,494,522,43,71,0.3295412435703861,0.5388039297768725,0.13165482665274145,0.37832908479304084,0.49454118938634894,0.12712972582061027,1,0,2,2,2,0,1
468,320,539,-148,71,0.42203985177224257,0.453448360516472,0.12451178771128533,0.5074244418850977,0.3663902571947788,0.1261853009201237,1,0,1,1,2,0,0
433,482,628,49,195,0.23830831378221978,0.6391806464863277,0.1225110397314525,0.4819650409784742,0.3849203890168411,0.1331145700046845,1,0,1,1,2,0,1
243,254,304,11,61,0.43579268580151315,0.44413617769617963,0.12007113650230725,0.4694481609015732,0.4170154017495748,0.11353643734885192,1,1,1,3,4,0,1
634,498,592,-136,-42,0.40549820849807977,0.4733157891163459,0.12118600238557428,0.5155985747043922,0.3721029486777762,0.11229847661783134,0,0,1,2,0,1,0
358,228,293,-130,-65,0.3459367456793604,0.5497187966038415,0.10434445771679791,0.5075646413773451,0.37689890868768866,0.11553644993496634,0,0,2,1,0,1,0
358,455,498,97,140,0.444216943242677,0.42951848890326544,0.12626456785405782,0.44899935037783045,0.430051731768394,0.12094891785377532,1,0,1,1,2,0,1
391,427,462,36,71,0.43096885468732193,0.44114181420031046,0.12788933111236758,0.48343620276161553,0.40456837412710495,0.11199542311127934,1,0,2,1,2,0,1
407,371,386,-36,-21,0.4179366207239324,0.45438645747069595,0.12767692180537146,0.4553243662889681,0.4333907770989472,0.11128485661208473,1,1,1,1,4,1,0
269,217,232,-52,-37,0.4412692946251152,0.42681942927836397,0.1319112760965207,0.42797970631200505,0.46111402965888115,0.11090626402911367,1,0,2,2,2,1,0
360,141,202,-219,-158,0.5046185379764574,0.38497618019578195,0.1104052818277609,0.4447960869387069,0.44200887108444425,0.11319504197684871,1,0,1,1,2,1,0
364,258,269,-106,-95,0.5178060619360362,0.383019033434388,0.09917490462957569,0.5021220581350945,0.3846803193879793,0.11319762247692618,0,1,4,1,1,1,0
314,266,292,-48,-22,0.28406505531725895,0.6039921185865857,0.1119428260961553,0.3845896003780766,0.5071394874682483,0.10827091215367497,1,0,1,1,3,1,0
284,249,270,-35,-14,0.45128148083930697,0.4192596327560569,0.12945888640463624,0.4034123790280572,0.48465237759212154,0.11193524337982154,1,1,1,3,4,1,0
547,496,527,-51,-20,0.28775499587661724,0.5618887216056266,0.15035628251775607,0.40169903556509423,0.48443915711391083,0.11386180732099477,1,0,2,1,2,1,0
222,173,199,-49,-23,0.44608525032236923,0.4484252131205093,0.10548953655712177,0.4196890099431187,0.46797304429340614,0.11233794576347528,0,1,3,1,1,1,0
328,236,284,-92,-44,0.38101939400325036,0.518353389858906,0.1006272161378436,0.39176844297617747,0.49794419464677114,0.11028736237705111,1,1,2,1,4,1,0
443,336,379,-107,-64,0.5174198591269684,0.3683292263251855,0.11425091454784615,0.4871304278401271,0.39799695562940335,0.1148726165304695,1,0,4,1,2,1,0
353,150,260,-203,-93,0.4205905381220505,0.43069964346945194,0.14870981840849753,0.5444165604385158,0.3411153858680174,0.11446805369346677,1,1,2,1,4,1,0
431,263,451,-168,20,0.4022524823769261,0.45198422323202364,0.14576329439105024,0.37655759629086616,0.5114975123361948,0.11194489137293917,1,1,1,2,4,0,0
376,284,321,-92,-55,0.5158099982016646,0.3671220161650496,0.11706798563328588,0.5427082712059405,0.34550872820892903,0.11178300058513076,1,0,2,1,2,1,0
283,207,260,-76,-23,0.32369272301500895,0.5676359171423919,0.10867135984259896,0.3872287000814335,0.49872379420441665,0.11404750571414977,1,1,1,1,4,1,0
353,292,328,-61,-25,0.3975543065442565,0.4795767383992768,0.12286895505646679,0.40262176605544986,0.4726343952211825,0.12474383872336758,1,0,1,1,3,1,0
482,326,475,-156,-7,0.4174439520532065,0.44911009456497175,0.13344595338182194,0.4599204772540704,0.4239956157965977,0.11608390694933157,1,1,1,1,4,1,0
247,139,220,-108,-27,0.3949288669891755,0.48121697762202825,0.12385415538879642,0.4704975047079213,0.41727641239396185,0.11222608289811663,0,0,2,1,0,1,0
474,285,434,-189,-40,0.35927479376667715,0.5325374402556703,0.10818776597765214,0.5359452316412032,0.34704228543209553,0.11701248292670134,1,0,2,1,2,1,0
198,226,253,28,55,0.4849202854157323,0.4022605563713692,0.11281915821289822,0.42356181882812044,0.46290168039565965,0.1135365007762201,0,0,1,2,0,0,1
450,383,432,-67,-18,0.4126030035449779,0.4578962964210045,0.12950070003401737,0.3985261701599474,0.4900365446984712,0.1114372851415816,1,0,1,4,2,1,0
120,19,60,-101,-60,0.5046185379764574,0.38497618019578195,0.1104052818277609,0.4447960869387069,0.44200887108444425,0.11319504197684871,0,1,1,1,1,1,0
355,371,401,16,46,0.4997975535329781,0.38906484534010344,0.11113760112691866,0.5094236873219514,0.37783199343949053,0.11274431923855821,1,0,3,1,2,0,1
247,139,200,-108,-47,0.4503983400083517,0.45188093832513837,0.09772072166650984,0.44079536784998447,0.44681407546290003,0.11239055668711519,1,1,2,1,4,1,0
296,241,265,-55,-31,0.2745290202510093,0.6035302204538353,0.12194075929515545,0.46148888368965396,0.4219346678373587,0.11657644847298737,1,0,1,2,2,1,0
382,265,338,-117,-44,0.28792278110919645,0.546583379158733,0.16549383973207082,0.508557671041486,0.38480979174286467,0.10663253721564919,1,0,2,1,2,1,0
205,159,194,-46,-11,0.4394031030185782,0.44120218222982205,0.11939471475159968,0.4560851049008784,0.432282661849788,0.11163223324933344,0,0,1,2,0,1,0
258,70,89,-188,-169,0.4572379624856194,0.4255424126169374,0.11721962489744292,0.421786219917831,0.46526252061496237,0.11295125946720692,1,1,1,1,4,1,0
341,274,312,-67,-29,0.26478473510124567,0.5859173717314196,0.1492978931673344,0.40819643227163427,0.4835487525597278,0.1082548151686379,0,0,3,1,0,1,0
292,199,277,-93,-15,0.4348923680049734,0.4630573222163351,0.10205030977869173,0.44663274763947264,0.4327801812831816,0.1205870710773457,0,1,3,1,1,1,0
352,247,305,-105,-47,0.3336328660057947,0.5278043172596943,0.13856281673451096,0.42311507764820233,0.46723340564397337,0.10965151670782425,1,0,1,1,2,1,0
299,245,382,-54,83,0.42112280365858773,0.46221404638882435,0.11666314995258807,0.46902196101105337,0.40041792907714907,0.1305601099117972,1,0,2,1,2,0,0
282,313,349,31,67,0.36616821078317036,0.5151262921984552,0.11870549701837442,0.43046146732235074,0.45806194224751046,0.11147659043013887,1,0,1,5,2,0,1
279,235,252,-44,-27,0.4025709535624981,0.4868108095208888,0.11061823691661318,0.36744164128391643,0.5217843643801082,0.11077399433597526,1,0,3,5,3,1,0
419,306,360,-113,-59,0.47359507257872124,0.4186827458789691,0.1077221815423095,0.4065590431382228,0.482573240780779,0.11086771608099835,0,0,1,1,0,1,0
373,239,337,-134,-36,0.39518665174165285,0.47791064592835825,0.1269027023299892,0.41618024816905674,0.4725480212826845,0.11127173054825892,1,0,3,3,2,1,0
174,0,149,-174,-25,0.49477063079647265,0.39683825075437223,0.10839111844915494,0.4950365173394692,0.3918686003206758,0.11309488233985485,1,1,1,1,4,1,0
243,198,228,-45,-15,0.4539948974423497,0.4349306297151409,0.11107447284250965,0.4800038972768657,0.4050415546227621,0.11495454810037205,0,1,1,1,1,1,0
404,59,238,-345,-166,0.4066003311415341,0.4733575752190994,0.12004209363936617,0.4312123653191993,0.44565437774833777,0.12313325693246305,1,1,1,1,4,1,0
113,32,88,-81,-25,0.5046185379764574,0.38497618019578195,0.1104052818277609,0.4447960869387069,0.44200887108444425,0.11319504197684871,1,1,1,1,4,1,0
261,200,340,-61,79,0.366422298193801,0.5183471692110485,0.11523053259515063,0.49518022429079817,0.37622184196462805,0.12859793374457368,1,1,1,1,4,0,0
457,497,536,40,79,0.4955097812463446,0.38341687689271603,0.12107334186093913,0.5002082469261392,0.3703071484704235,0.12948460460343747,1,0,2,1,2,0,1
210,221,255,11,45,0.38292596125110895,0.4904160067636841,0.12665803198520692,0.3821684461927454,0.5047908320721439,0.1130407217351108,1,0,1,2,3,0,1
302,234,268,-68,-34,0.44681757279962425,0.43801284931930823,0.11516957788106763,0.46984637369540244,0.4182367777969881,0.11191684850760933,1,1,1,4,4,1,0
246,188,327,-58,81,0.3969352717721269,0.47963554450265533,0.12342918372521758,0.4055160150615015,0.4765097029512545,0.11797428198724408,1,0,1,1,2,0,0
336,204,235,-132,-101,0.44604946459851413,0.433006076765768,0.12094445863571762,0.5430460366760397,0.3425276404517177,0.11442632287224264,0,0,2,1,0,1,0
259,192,235,-67,-24,0.46838908507403,0.4209670528090223,0.11064386211694788,0.3891903402370785,0.49557209341338215,0.11523756634953938,1,1,2,2,4,1,0
467,222,404,-245,-63,0.4671965403595806,0.4203382506617303,0.11246520897868877,0.5296437352807312,0.35205924742141353,0.11829701729785547,0,1,4,2,1,1,0
260,202,279,-58,19,0.43456215694833417,0.42710976531253353,0.1383280777391323,0.45388794216845246,0.43443808264836187,0.11167397518318567,1,0,1,1,2,0,0
342,227,311,-115,-31,0.44081076612727016,0.4386376456042687,0.12055158826846091,0.49302928932673906,0.39384116415838893,0.11312954651487211,1,0,1,1,3,1,0
222,84,106,-138,-116,0.4714901483929121,0.4075601331947473,0.12094971841234067,0.48375255949978097,0.40052571867345643,0.11572172182676256,0,1,1,1,1,1,0
297,237,278,-60,-19,0.45541719016048154,0.42259842484514726,0.12198438499437138,0.4408890082070182,0.4472000473808163,0.11191094441216543,1,1,1,1,4,1,0
499,421,449,-78,-50,0.4088333099211527,0.4761987388586725,0.11496795122017461,0.38956848927300497,0.5010655462668692,0.10936596446012561,1,1,1,1,4,1,0
304,196,274,-108,-30,0.4415235100007726,0.4414527506279017,0.11702373937132539,0.46608610447833115,0.4203936960637097,0.11352019945795927,1,0,1,1,2,1,0
371,261,309,-110,-62,0.42827618280373436,0.4472880278015304,0.12443578939473542,0.4938229324869514,0.3903431966822196,0.11583387083082869,0,0,2,1,0,1,0
619,533,551,-86,-68,0.18240677278594036,0.6841246403069006,0.1334685869071593,0.3369509178392821,0.551136165689225,0.111912916471493,1,0,1,5,2,1,0
421,292,303,-129,-118,0.4365436985168657,0.4374526964483619,0.12600360503477231,0.3576938121989177,0.5310202618693158,0.11128592593176662,0,0,2,1,0,1,0
285,194,224,-91,-61,0.41696686473545447,0.47290886900011053,0.11012426626443513,0.44148475236872886,0.4359838536484904,0.12253139398278057,1,0,2,1,3,1,0
368,346,390,-22,22,0.44379558730854696,0.4453219793589918,0.11088243333246124,0.4864962522159759,0.4024352842682223,0.11106846351580188,0,0,1,3,0,0,0
332,204,313,-128,-19,0.4388597708058783,0.4333993101658704,0.12774091902825147,0.48625428729207626,0.39907889926752355,0.11466681344040032,1,0,2,1,2,1,0
333,224,241,-109,-92,0.3917098906212955,0.4961421137684417,0.11214799561026281,0.4241220788020643,0.455019665170324,0.12085825602761158,0,0,1,1,0,1,0
251,200,211,-51,-40,0.43023401213895607,0.4622627940388437,0.10750319382220036,0.36404581164018635,0.523579230107677,0.11237495825213649,0,0,2,1,0,1,0
426,213,475,-213,49,0.3414591733821889,0.5386574045516132,0.11988342206619786,0.4095136924815815,0.4810670320512845,0.10941927546713386,1,0,1,1,2,0,0
261,212,233,-49,-28,0.3897029567696449,0.4892745287515579,0.12102251447879739,0.4819253595703148,0.40454780196830853,0.1135268384613769,1,1,1,1,4,1,0
259,230,294,-29,35,0.45969909107403345,0.4291033723060474,0.11119753661991925,0.41151904204863204,0.4769675751629728,0.11151338278839526,1,1,1,2,4,0,0
484,211,323,-273,-161,0.339970771929835,0.5473046691517321,0.11272455891843311,0.38201619527091635,0.5071822205236685,0.11080158420541507,1,0,1,3,2,1,0
169,131,181,-38,12,0.3861593447980657,0.47940453008979833,0.134436125112136,0.3909767320872425,0.4976572304954578,0.11136603741729985,1,0,1,1,2,0,0
457,396,443,-61,-14,0.43102171770877334,0.45252326406762833,0.11645501822359838,0.494707192832068,0.3946740540215268,0.11061875314640529,0,0,4,1,0,1,0
583,565,603,-18,20,0.3720229037138503,0.4507363083170276,0.17724078796912196,0.45136948951402495,0.43746996980435376,0.1111605406816211,1,0,1,3,2,0,0
353,384,603,31,250,0.41209745071813186,0.4518303191358043,0.1360722301460638,0.5183566299351524,0.3638401824547418,0.11780318761010551,1,0,1,1,2,0,1
349,187,237,-162,-112,0.4196046707335913,0.4318487479783807,0.14854658128802806,0.44515805133322817,0.4428436756229224,0.11199827304384967,0,0,1,2,0,1,0
375,134,411,-241,36,0.4556978752478551,0.42842407738843524,0.1158780473637096,0.4482966875177609,0.43238845230479844,0.11931486017744043,0,0,1,2,0,0,0
343,315,332,-28,-11,0.5002370453335726,0.394507512365495,0.10525544230093235,0.46699741289832847,0.4168006417327279,0.11620194536894361,1,0,2,1,2,1,0
283,200,214,-83,-69,0.38378147852021116,0.48433018865627603,0.1318883328235126,0.5356541062537797,0.3337492800416297,0.13059661370459072,0,0,2,3,0,1,0
291,299,371,8,80,0.2914569597382252,0.5673970196620277,0.1411460205997471,0.4217987556786873,0.45600313232924816,0.12219811199206458,1,0,1,1,2,0,1
401,510,572,109,171,0.39381811869445443,0.4659707746881158,0.14021110661742953,0.47271617151541023,0.3906295898836897,0.13665423860090015,0,0,2,1,0,0,1
260,219,241,-41,-19,0.44401334003003623,0.4569186427082247,0.09906801726173925,0.44674927081758947,0.4422512340611845,0.11099949512122603,1,1,2,2,4,1,0
300,233,275,-67,-25,0.3768966301372873,0.49538676117330144,0.12771660868941145,0.36381518731333884,0.5234511758202268,0.11273363686643442,1,0,1,1,2,1,0
379,321,358,-58,-21,0.35921586666081534,0.5286343082971265,0.11214982504205809,0.45409052436218106,0.4302698151999115,0.11563966043790712,1,0,2,1,2,1,0
238,184,216,-54,-22,0.3982281676658751,0.4673854673655661,0.13438636496855874,0.4386723992718735,0.44999951127930277,0.11132808944882361,1,0,2,1,2,1,0
274,195,257,-79,-17,0.4553630003851958,0.4338189403196616,0.11081805929514256,0.4521878018182477,0.43112375839186556,0.11668843978988672,0,0,2,1,0,1,0
330,361,375,31,45,0.41131657547644446,0.46363334218749785,0.1250500823360578,0.48140996183864704,0.4043299027564132,0.11426013540493965,1,0,3,4,2,0,1
358,236,324,-122,-34,0.4000222823913345,0.488631421126925,0.11134629648174033,0.473208718517983,0.4153939868648812,0.11139729461713575,1,0,1,2,3,1,0
368,299,333,-69,-35,0.38350625886776185,0.4945163317506265,0.12197740938161163,0.40694585131336913,0.48115898936071605,0.1118951593259145,1,0,2,1,2,1,0
307,245,256,-62,-51,0.400678759718566,0.4822721023510919,0.11704913793034229,0.43023939142377216,0.45789904404684545,0.11186156452938253,0,0,2,2,0,1,0
397,338,363,-59,-34,0.46427841990741203,0.42573429224213666,0.10998728785045114,0.4823310578514047,0.40093533489330574,0.11673360725528933,1,0,1,1,3,1,0
545,450,485,-95,-60,0.36381787128595383,0.49072243916337704,0.14545968955066899,0.3115923159600033,0.5749916744731628,0.1134160095668339,1,1,1,2,4,1,0
205,180,196,-25,-9,0.5039975876433231,0.38998211148453316,0.10602030087214373,0.47088163967732277,0.413697993159893,0.11542036716278425,0,0,2,2,0,1,0
373,300,351,-73,-22,0.44119055272963936,0.4191059644642282,0.13970348280613265,0.5175517519951317,0.36764107334501145,0.11480717465985694,1,0,3,1,2,1,0
310,321,341,11,31,0.4830158634644617,0.4176665054575804,0.09931763107795785,0.5062495301997887,0.38374023038861144,0.1100102394115998,1,0,4,1,2,0,1
477,284,314,-193,-163,0.3367741459243941,0.5006690786901886,0.16255677538541752,0.47951648397855406,0.39052838754215813,0.12995512847928767,0,1,1,1,1,1,0
136,82,99,-54,-37,0.5035493158117175,0.3888050138133074,0.10764567037497516,0.4990356075726834,0.38400355966268107,0.11696083276463573,1,1,2,2,4,1,0
396,275,351,-121,-45,0.4804427710120479,0.38160139370588697,0.13795583528206518,0.4582111170565078,0.42098174080057776,0.12080714214291445,0,1,4,2,1,1,0
299,224,245,-75,-54,0.4602621078535747,0.4245221620295123,0.11521573011691325,0.42296899509863795,0.4655742357090027,0.11145676919235915,0,1,2,2,1,1,0
365,325,341,-40,-24,0.33832452005917507,0.528413211164586,0.13326226877623887,0.3485615373848288,0.5410680897832024,0.11037037283196871,1,1,3,2,4,1,0
330,339,380,9,50,0.40878574772109755,0.47381022247288335,0.11740402980601915,0.42022280587436533,0.45152716986444835,0.1282500242611862,1,0,1,1,2,0,1
353,253,269,-100,-84,0.5783079797271378,0.3366092265555076,0.08508279371735475,0.5491162619651815,0.3340456794801282,0.11683805855469032,0,1,3,2,1,1,0
314,261,284,-53,-30,0.46576508247353615,0.41997631317515544,0.11425860435130837,0.4340792304674212,0.4542251986804078,0.11169557085217091,1,0,2,1,2,1,0
290,204,236,-86,-54,0.4503586260679793,0.4257049231302903,0.1239364508017305,0.42715215797093237,0.46364068704735856,0.1092071549817091,1,1,1,1,4,1,0
251,92,106,-159,-145,0.510165459581145,0.37721769157595064,0.11261684884290436,0.422027587984869,0.466028200128285,0.11194421188684582,1,1,1,1,4,1,0
252,270,300,18,48,0.46399473568060284,0.4383431428763641,0.09766212144303289,0.4876312516254842,0.39789359195730817,0.11447515641720767,1,0,1,1,2,0,1
347,376,394,29,47,0.4259254890182981,0.4539492710137538,0.12012523996794823,0.472666180293092,0.41630347182226995,0.11103034788463809,1,0,1,1,2,0,1
332,376,387,44,55,0.3882282082037425,0.5182002293598637,0.09357156243639372,0.4600038788785442,0.42941896415792,0.11057715696353625,1,0,2,2,2,0,1
311,179,203,-132,-108,0.41056446674303965,0.47716251994947045,0.11227301330748991,0.43124141268956234,0.4581876361575847,0.1105709511528532,1,0,1,1,2,1,0
375,262,275,-113,-100,0.3429655456857453,0.546427814398903,0.11060663991535172,0.490010813480512,0.3936868704406353,0.11630231607885301,1,0,1,3,3,1,0
255,420,476,165,221,0.42834275588213583,0.43157892370113754,0.1400783204167266,0.4127148267512349,0.4610596991620848,0.12622547408668025,1,0,1,1,2,0,1
299,165,256,-134,-43,0.38661527439498694,0.47843883160448947,0.1349458940005238,0.364616555755931,0.5239751304965873,0.11140831374748178,0,0,4,1,0,1,0
268,170,289,-98,21,0.25868596135617683,0.6311446113635232,0.11016942728030013,0.375786060489921,0.5117110347704961,0.11250290473958276,1,1,1,1,4,0,0
416,359,399,-57,-17,0.43350810963182534,0.4580495249240532,0.10844236544412161,0.34522998265438815,0.5464290802007403,0.10834093714487186,1,0,3,1,2,1,0
385,249,356,-136,-29,0.4737274533361981,0.4290940313316667,0.09717851533213517,0.47108938978253584,0.4207543208149345,0.10815628940252948,1,0,1,1,2,1,0
308,264,280,-44,-28,0.4874560397189339,0.3949630803661257,0.11758087991494047,0.48119723788996166,0.40661125245343627,0.11219150965660205,1,0,1,1,2,1,0
501,374,390,-127,-111,0.2599435446555763,0.6420487546770703,0.09800770066735298,0.3438334787216009,0.5427675586553371,0.11339896262306191,0,1,1,1,1,1,0
540,470,563,-70,23,0.3353353205387151,0.5536215849246717,0.1110430945366134,0.3456342608587173,0.5465127250128503,0.10785301412843251,1,0,1,1,3,0,0
335,266,346,-69,11,0.42465551385515315,0.4565029179141387,0.1188415682307081,0.3491480293004567,0.5397836311194328,0.11106833958011006,1,0,3,3,2,0,0
171,0,161,-171,-10,0.4205031105494358,0.439763001400642,0.13973388804992237,0.5064845772085732,0.3760617128116556,0.11745370997977096,0,1,1,1,1,1,0
258,189,232,-69,-26,0.4461335762926837,0.4339995222123615,0.11986690149495484,0.4151811206688808,0.4719378363397527,0.11288104299136653,0,0,1,1,0,1,0
332,251,351,-81,19,0.4620971002448007,0.41383982776526873,0.12406307198993045,0.4231018973249582,0.46376822199911527,0.11312988067592618,1,0,1,2,2,0,0
344,301,374,-43,30,0.44323491647220087,0.4322366419935767,0.12452844153422242,0.36281469220669754,0.5235473026034861,0.11363800518981636,1,0,4,1,2,0,0
295,402,518,107,223,0.39083594866711957,0.48726981796787755,0.1218942333650032,0.44031740653536605,0.44353366674150324,0.11614892672313061,1,0,1,1,2,0,1
292,185,397,-107,105,0.4104226565338134,0.46210465391345057,0.1274726895527365,0.35981853111258433,0.5296168764853277,0.1105645924020878,0,1,1,1,1,0,0
338,366,378,28,40,0.38503722703354487,0.4940224052045744,0.12094036776188061,0.4666584978247829,0.4150791107535978,0.1182623914216194,1,1,3,2,4,0,1
364,297,326,-67,-38,0.3077286814021191,0.562911429274196,0.12935988932368503,0.3812880007769796,0.5068082693111373,0.11190372991188316,0,1,3,2,1,1,0
307,248,277,-59,-30,0.4142037000469785,0.45403684112669424,0.1317594588263273,0.4663749182074941,0.4097603887586261,0.12386469303388005,1,0,1,2,2,1,0
271,154,200,-117,-71,0.45350144380088225,0.4444417344791916,0.10205682171992586,0.3941061815239678,0.49593877788751817,0.10995504058851395,1,1,2,3,4,1,0
281,249,272,-32,-9,0.49250189313991954,0.39119922532622003,0.11629888153386038,0.38427025265644776,0.5051634516151858,0.11056629572836668,0,0,1,3,0,1,0
142,0,101,-142,-41,0.4305289878688364,0.4635350993339896,0.10593591279717401,0.4407145739609759,0.44950753319123843,0.10977789284778584,0,1,1,1,1,1,0
295,135,319,-160,24,0.4363664840479504,0.4571654372780071,0.1064680786740425,0.3734319086993276,0.5170811182251953,0.109486973075477,1,1,1,3,4,0,0
417,241,306,-176,-111,0.30037047051328897,0.5838940848936545,0.11573544459305658,0.44300274778191934,0.4267293130320976,0.13026793918598295,0,0,2,1,0,1,0
350,112,244,-238,-106,0.43995063024988207,0.4440793090165454,0.11597006073357224,0.3886005404045567,0.49996410429233895,0.11143535530310439,1,1,1,3,4,1,0
333,216,352,-117,19,0.4627014148772711,0.42303008321297597,0.1142685019097528,0.47592709145507633,0.40482043963741665,0.11925246890750671,1,0,1,2,2,0,0
276,179,227,-97,-49,0.40434567011600453,0.4853154190692747,0.1103389108147206,0.44771136927775607,0.4388621665225549,0.1134264641996891,1,1,3,1,4,1,0
324,251,266,-73,-58,0.5017829749056237,0.3847328310158283,0.11348419407854779,0.5085431960997847,0.3749734641590468,0.11648333974116823,1,1,1,1,4,1,0
445,211,356,-234,-89,0.317109171744473,0.5606680040012983,0.1222228242542288,0.47886099557448364,0.40944223192330315,0.11169677250221337,0,0,3,1,0,1,0
298,194,223,-104,-75,0.37042178858824726,0.5131452917239082,0.11643291968784449,0.37078577836536536,0.5162799527210529,0.11293426891358194,0,1,1,2,1,1,0
284,113,200,-171,-84,0.5628281676865009,0.32801118714644517,0.10916064516705415,0.4931839952607065,0.39143762077744676,0.11537838396184665,0,1,1,1,1,1,0
310,291,297,-19,-13,0.36691882837443357,0.5023849023631535,0.13069626926241273,0.35916147098138984,0.5302718827168316,0.11056664630177855,1,0,2,2,2,1,0
383,396,432,13,49,0.4133788371082569,0.46339488689782266,0.12322627599392028,0.4997332807711562,0.391625174561024,0.10864154466781965,0,0,3,1,0,0,1
342,223,322,-119,-20,0.29712215673877024,0.5934980049412771,0.10937983831995272,0.39132882830160826,0.47514208769061794,0.13352908400777364,0,1,1,1,1,1,0
109,0,133,-109,24,0.42981633665192365,0.4605525498529874,0.10963111349508889,0.485136495958041,0.4007625412303989,0.11410096281155985,1,1,1,1,4,0,0
431,396,486,-35,55,0.39522367452321155,0.5007000652144092,0.10407626026237936,0.5286523590482334,0.3603760855858492,0.11097155536591728,0,0,4,3,0,0,0
351,226,245,-125,-106,0.3801174644845962,0.47290556357789315,0.14697697193751041,0.45669865603269505,0.4191004706923313,0.12420087327497346,1,1,1,1,4,1,0
455,355,392,-100,-63,0.1978218601283283,0.6680172539455086,0.13416088592616274,0.5329759969062254,0.35040303241647924,0.1166209706772955,0,0,2,1,0,1,0
366,269,340,-97,-26,0.40205766753400957,0.48776559756893895,0.1101767348970515,0.39985725683285506,0.48782296161931876,0.11231978154782617,0,0,2,1,0,1,0
426,311,395,-115,-31,0.40898921289132084,0.48573428108900835,0.10527650601967084,0.4185924418944222,0.4716374120243851,0.10977014608119262,1,0,1,2,2,1,0
263,160,179,-103,-84,0.4687051812146555,0.4310871190406732,0.10020769974467145,0.44875841886557627,0.4381894487881711,0.11305213234625269,0,0,2,1,0,1,0
352,258,413,-94,61,0.33905818818414923,0.5266869602295983,0.13425485158625247,0.4172994164403945,0.46708924111115907,0.11561134244844655,1,0,1,1,2,0,0
412,226,333,-186,-79,0.3406094685343014,0.4871857152319073,0.17220481623379114,0.5395558098680624,0.34122969872610753,0.11921449140583028,1,1,2,1,4,1,0
308,214,275,-94,-33,0.3975411656623655,0.480099986085853,0.12235884825178109,0.4309722041813503,0.44803565840280324,0.12099213741584657,0,0,1,1,0,1,0
364,327,375,-37,11,0.5049713592582777,0.38926021056884536,0.10576843017287706,0.3697403895043295,0.5173927158281729,0.11286689466749777,1,1,1,3,4,0,0
280,173,234,-107,-46,0.4890446915955897,0.39025133160233194,0.12070397680207834,0.45268491250279025,0.43512320876873684,0.1121918787284726,1,0,1,2,2,1,0
287,131,237,-156,-50,0.4696910679081495,0.40800110333622364,0.12230782875562686,0.5356417460527384,0.34811151320561184,0.11624674074164952,0,1,3,1,1,1,0
334,190,201,-144,-133,0.3552943023619951,0.5097637436662287,0.13494195397177605,0.37716989977375315,0.5131312758262949,0.1096988243999521,0,0,1,2,0,1,0
321,300,313,-21,-8,0.32965109405568577,0.5586867634430035,0.11166214250131064,0.34641875120396587,0.5443124698858133,0.10926877891022065,0,1,5,5,1,1,0
208,159,241,-49,33,0.3206029870178282,0.5385957288637592,0.14080128411841264,0.3838650526799949,0.504313840567859,0.11182110675214614,1,0,2,1,2,0,0
298,206,280,-92,-18,0.4917276738054922,0.4041348193884244,0.10413750680608347,0.5004519615424371,0.3686959124666927,0.13085212599086973,0,0,1,1,0,1,0
444,340,408,-104,-36,0.31149133967529813,0.5748878291472923,0.11362083117740948,0.4428902233128528,0.4439191884067403,0.11319058828040676,1,0,4,1,2,1,0
535,356,463,-179,-72,0.4425135850751658,0.4366988042326443,0.12078761069218978,0.42579143106578127,0.4622288133187712,0.11197975561544737,0,1,1,1,1,1,0
469,334,450,-135,-19,0.4408284139446121,0.4612635407143179,0.09790804534107009,0.37428959366954995,0.5166696177080445,0.10904078862240545,0,0,1,2,0,1,0
428,305,396,-123,-32,0.4934445149065308,0.39795513129289434,0.10860035380057503,0.5376645388900888,0.3436672943761211,0.11866816673378984,0,0,1,1,0,1,0
247,161,190,-86,-57,0.4772818892602671,0.4094843220968267,0.11323378864290624,0.44433730800077453,0.44401502297841805,0.11164766902080742,1,0,4,1,2,1,0
713,534,565,-179,-148,0.3713384321047456,0.5096426001647367,0.11901896773051802,0.3326184688633132,0.525031631382218,0.142349899754469,1,0,3,1,2,1,0
327,262,281,-65,-46,0.5217445320694738,0.3530099170919393,0.1252455508385865,0.4189631552754465,0.4704031951386233,0.11063364958593043,0,0,1,2,0,1,0
120,0,47,-120,-73,0.4651965557506011,0.41835065507947966,0.11645278916991932,0.4593008750486808,0.43049598200151007,0.11020314294980897,0,0,1,1,0,1,0
420,274,297,-146,-123,0.4306845070812018,0.42656095288897095,0.1427545400298272,0.3711890882786567,0.5194037721135567,0.10940713960778656,0,1,1,3,1,1,0
266,64,71,-202,-195,0.36012563023462346,0.532454950104222,0.10741941966115415,0.41143212670798274,0.47628661982787657,0.11228125346414053,1,1,1,1,4,1,0
344,298,324,-46,-20,0.39933488982498194,0.45615306649016074,0.1445120436848574,0.47070048349185284,0.41918010321218035,0.11011941329596697,1,0,1,1,2,1,0
280,300,308,20,28,0.36260187804715716,0.515034272926154,0.12236384902668891,0.45764573699246086,0.4302082829950195,0.11214598001251944,1,1,5,1,4,0,1
343,269,280,-74,-63,0.4907195174199994,0.39634845077683556,0.11293203180316491,0.472574247338496,0.4107165887993702,0.11670916386213426,0,1,2,2,1,1,0
256,187,242,-69,-14,0.40453145907011356,0.4589912702751466,0.13647727065473994,0.36722383918342943,0.5265281300472918,0.1062480307692787,1,0,1,2,2,1,0
268,185,253,-83,-15,0.44960180535019034,0.43583612702640223,0.11456206762340765,0.43431926172470925,0.45279202353012377,0.11288871474516705,1,0,2,1,2,1,0
462,546,572,84,110,0.42880643289172754,0.43312042161014075,0.13807314549813188,0.45685320870131185,0.43059165546416955,0.1125551358345186,1,0,1,2,2,0,1
342,260,318,-82,-24,0.5611659388140066,0.3380121807835739,0.10082188040241948,0.4966677992382871,0.3881262028700513,0.11520599789166128,0,1,1,1,1,1,0
374,305,321,-69,-53,0.3372199180938968,0.5142723153691946,0.14850776653690845,0.4140223105228755,0.47396050848879795,0.11201718098832669,1,0,2,1,2,1,0
332,276,305,-56,-27,0.3697279502337402,0.5210775752919612,0.1091944744742984,0.49935366625726146,0.3836492795633368,0.11699705417940198,1,0,1,1,3,1,0
453,235,415,-218,-38,0.3674218825750471,0.5099694963569388,0.12260862106801437,0.5458355065679632,0.3426553996053871,0.11150909382664963,1,1,2,1,4,1,0
154,99,116,-55,-38,0.47800634031623657,0.38529974394244326,0.1366939157413202,0.4423624521334417,0.44245287007870976,0.11518467778784834,1,1,1,1,4,1,0
324,221,247,-103,-77,0.45271078401216774,0.4527487032180243,0.0945405127698081,0.5190789354028054,0.3695224623427895,0.11139860225440493,1,0,1,3,3,1,0
437,287,314,-150,-123,0.46058936113067767,0.4122051273633645,0.12720551150595777,0.3609566238451677,0.5263474169635235,0.11269595919130915,1,0,1,1,3,1,0
354,231,326,-123,-28,0.2968499564985541,0.5798746115413718,0.12327543196007425,0.3658371150599289,0.5232078156223334,0.11095506931773777,0,0,1,2,0,1,0
545,463,518,-82,-27,0.3704474402836808,0.4983425083226675,0.13121005139365163,0.38492024136634223,0.5020316398346706,0.11304811879898691,1,0,1,1,2,1,0
274,231,246,-43,-28,0.4164451500315436,0.4770941356002869,0.10646071436816987,0.41025528861127286,0.477070156337316,0.11267455505141112,1,1,2,2,4,1,0
252,280,302,28,50,0.47400408122657905,0.41110632312602474,0.11488959564739636,0.5026219076076186,0.38303036635088494,0.11434772604149646,1,0,3,1,2,0,1
193,16,90,-177,-103,0.5046185379764574,0.38497618019578195,0.1104052818277609,0.4447960869387069,0.44200887108444425,0.11319504197684871,1,1,1,1,4,1,0
279,147,246,-132,-33,0.5230416373692879,0.37411048382420176,0.10284787880651032,0.4426796360914211,0.444329081912422,0.11299128199615689,0,0,1,1,0,1,0
286,308,429,22,143,0.37866458749905496,0.48824502425354555,0.13309038824739927,0.47831559996523304,0.4058712094169225,0.11581319061784448,1,0,2,1,2,0,1
309,229,246,-80,-63,0.3804540676474749,0.5094080780770425,0.11013785427548274,0.3946160367715561,0.49419927614830383,0.11118468708013991,1,0,1,3,2,1,0
104,82,157,-22,53,0.5083366410516859,0.3787674539737352,0.11289590497457871,0.45019849398156564,0.43716659341212755,0.11263491260630662,1,1,1,2,4,0,0
375,154,187,-221,-188,0.48695939075768835,0.4045653757391684,0.108475233503143,0.4273247295522475,0.46127733127047177,0.11139793917728068,0,0,1,2,0,1,0
304,272,289,-32,-15,0.3297888425272814,0.539025391834253,0.13118576563846573,0.45815211981281656,0.42174770968376657,0.12010017050341688,0,0,2,1,0,1,0
265,221,242,-44,-23,0.4719350355620679,0.3992538155937848,0.12881114884414732,0.4518330629399479,0.4217641719049973,0.12640276515505472,1,1,2,2,4,1,0
306,214,292,-92,-14,0.5548564402304023,0.34467194208891033,0.10047161768068742,0.5252418606979531,0.3545694153002238,0.12018872400182334,0,0,1,2,0,1,0
232,273,283,41,51,0.41946753028065853,0.47246953379565537,0.10806293592368613,0.40206532785667626,0.48648563176287385,0.1114490403804501,1,0,1,1,2,0,1
338,349,382,11,44,0.38481824434659456,0.5023433145014763,0.11283844115192905,0.5003345081695537,0.38269026212697954,0.1169752297034667,1,0,1,1,2,0,1
278,322,340,44,62,0.4593804084133525,0.4350831419286047,0.10553644965804303,0.38641358465103653,0.5028635774663656,0.11072283788259785,1,0,1,2,2,0,1
367,263,324,-104,-43,0.5045699696615671,0.3703157713451662,0.1251142589932668,0.5451492347842491,0.34138896806881097,0.11346179714693994,1,1,1,4,4,1,0
283,200,206,-83,-77,0.49201373157172484,0.3768691923142381,0.13111707611403656,0.444175560830346,0.43589336127254524,0.1199310778971086,1,1,1,1,4,1,0
316,135,210,-181,-106,0.38180362692422654,0.4863062649894747,0.13189010808629867,0.4012016576257921,0.47496487061280573,0.12383347176140179,0,1,1,1,1,1,0
309,253,268,-56,-41,0.4571331750519355,0.4261420226337151,0.11672480231434926,0.4704502884982425,0.41610190641863526,0.11344780508312231,0,0,3,3,0,1,0
364,247,271,-117,-93,0.4267054885748273,0.4500412600595863,0.12325325136558618,0.44200844785664994,0.4489475496972257,0.10904400244612428,1,1,1,3,4,1,0
469,421,451,-48,-18,0.47202699835328815,0.4108754941234012,0.11709750752331057,0.40719164801255564,0.48266866571153927,0.11013968627590501,1,0,2,3,2,1,0
314,238,295,-76,-19,0.44110479558587384,0.43180480616757605,0.12709039824655016,0.4078139111166099,0.47907316424299323,0.11311292464039693,1,0,1,1,2,1,0
674,465,567,-209,-107,0.1864914317596927,0.6491451458461102,0.16436342239419743,0.37270715978850655,0.496141665425665,0.13115117478582836,0,0,2,1,0,1,0
456,310,328,-146,-128,0.19751162833430436,0.5585373867292086,0.2439509849364866,0.43918380757897785,0.4513661415399725,0.10945005088104984,1,1,2,2,4,1,0
359,295,334,-64,-25,0.3871250097831294,0.47738911769386205,0.1354858725230087,0.49643649015059593,0.38904522944605074,0.11451828040335318,1,1,1,3,4,1,0
292,213,275,-79,-17,0.5209072487455615,0.3719993274933182,0.10709342376112013,0.48638011846670604,0.40004319165798635,0.1135766898753074,1,0,1,1,2,1,0
282,331,404,49,122,0.5046185379764574,0.38497618019578195,0.1104052818277609,0.4447960869387069,0.44200887108444425,0.11319504197684871,1,0,1,1,2,0,1
284,313,343,29,59,0.3498788104860862,0.5220318564113294,0.12808933310258377,0.3983947439529944,0.4916156177830721,0.10998963826393361,0,0,2,4,0,0,1
267,135,158,-132,-109,0.43599026810406755,0.44688586696466787,0.11712386493126459,0.5022936823823879,0.37753704586879977,0.12016927174881217,0,1,2,1,1,1,0
273,216,229,-57,-44,0.43156630436730703,0.4491806766848908,0.11925301894780198,0.4573657755692448,0.43173142218217603,0.11090280224857908,1,1,2,1,4,1,0
299,262,281,-37,-18,0.4494199082517481,0.4504564252139586,0.10012366653429297,0.487188149720093,0.3997279346610537,0.11308391561885342,1,0,3,3,2,1,0
62,0,46,-62,-16,0.5204472995236831,0.36433349414349414,0.11521920633282273,0.48660283648978003,0.3960687331139994,0.1173284303962208,0,1,1,1,1,1,0
371,398,437,27,66,0.4188856573593168,0.4560457007102462,0.12506864193043687,0.39402002811206766,0.4797875339400905,0.12619243794784188,1,0,1,1,2,0,1
289,8,29,-281,-260,0.49563717122252715,0.39546403984993606,0.10889878892753674,0.44824110838322934,0.43293153809077145,0.11882735352599924,1,0,1,1,3,1,0
353,284,327,-69,-26,0.4215522051179887,0.46739742294356534,0.11105037193844587,0.4575750565718614,0.42932506635054224,0.11309987707759626,1,0,3,4,2,1,0
262,215,243,-47,-19,0.4579766902115692,0.4260111632817356,0.11601214650669532,0.41333996641708354,0.47582114608463444,0.11083888749828186,0,0,1,1,0,1,0
283,111,150,-172,-133,0.4021913716278424,0.4841413473080534,0.11366728106410436,0.45722925093460154,0.4278179578938432,0.11495279117155496,0,0,4,1,0,1,0
465,281,425,-184,-40,0.480231078427255,0.4009664171409028,0.11880250443184208,0.4636982159204336,0.42236092434808936,0.11394085973147719,0,0,3,1,0,1,0
391,211,273,-180,-118,0.47513352885315624,0.3865320974512601,0.13833437369558366,0.5062027369668505,0.3805901788434692,0.11320708418968022,0,1,1,2,1,1,0
353,110,182,-243,-171,0.48569040754618115,0.41776637962174895,0.09654321283206996,0.45050928370632115,0.43122713311958255,0.11826358317409633,1,1,1,1,4,1,0
251,49,145,-202,-106,0.5046185379764574,0.38497618019578195,0.1104052818277609,0.4447960869387069,0.44200887108444425,0.11319504197684871,1,0,1,1,2,1,0
98,0,91,-98,-7,0.4876159110602355,0.3975448104136436,0.11483927852612096,0.4576205980322716,0.4297641630896661,0.11261523887806224,0,1,1,2,1,1,0
386,233,282,-153,-104,0.441872884099421,0.43518666209436674,0.12294045380621209,0.42278588510126386,0.46528128699788174,0.11193282790085417,0,0,1,2,0,1,0
458,345,380,-113,-78,0.26282717345950557,0.6134769758873669,0.12369585065312752,0.38962651206995474,0.501731203840867,0.10864228408917809,1,1,3,2,4,1,0
350,239,273,-111,-77,0.34704160993090355,0.5292692666683356,0.12368912340076074,0.4245061882917679,0.4650345193249214,0.11045929238331083,0,0,1,2,0,1,0
318,231,256,-87,-62,0.485868538529114,0.40839658950151136,0.10573487196937476,0.45342283688615653,0.4264335882156248,0.12014357489821843,1,1,1,1,4,1,0
269,158,175,-111,-94,0.5188576672996458,0.35565263661222796,0.12548969608812618,0.4494840567956876,0.4357734976547082,0.11474244554960421,1,0,1,1,2,1,0
316,178,275,-138,-41,0.4774515266991316,0.4073245992966999,0.1152238740041688,0.447105849884785,0.4414390993202543,0.11145505079496067,0,0,2,2,0,1,0
381,224,283,-157,-98,0.3878406895524476,0.5091963388560944,0.10296297159145786,0.42945593515785885,0.46297817515523754,0.10756588968690362,0,0,1,3,0,1,0
300,225,254,-75,-46,0.4528313526461799,0.43221624333528874,0.11495240401853118,0.4666433452058428,0.41795521029401184,0.11540144450014528,0,0,1,3,0,1,0
437,349,390,-88,-47,0.45622975022134,0.4517983202074585,0.09197192957120151,0.5281906675044421,0.359304310488467,0.11250502200709103,1,0,1,2,2,1,0
400,290,356,-110,-44,0.37584240109644157,0.49088282638383524,0.13327477251972347,0.4065706335788773,0.4840622697373495,0.10936709668377324,1,0,1,2,2,1,0
443,384,432,-59,-11,0.47832255985060473,0.4139971815105505,0.1076802586388447,0.398792020744441,0.49002882524181773,0.11117915401374154,1,1,1,4,4,1,0
1210,875,1186,-335,-24,0.13771342812148868,0.7016474928253296,0.16063907905318175,0.3048378093271118,0.5829940418173699,0.1121681488555185,1,0,1,1,3,1,0
493,371,464,-122,-29,0.4261643851711731,0.4604019514327699,0.11343366339605697,0.378790109786931,0.5102119049316441,0.11099798528142471,1,0,2,2,2,1,0
351,300,342,-51,-9,0.3876848443134579,0.4977740507583208,0.11454110492822134,0.39903184986629975,0.49075873851413937,0.11020941161956097,1,1,6,1,4,1,0
295,359,423,64,128,0.3337068007561713,0.5345934260860796,0.13169977315774922,0.49105211612054095,0.39356318479504243,0.1153846990844165,1,0,3,1,2,0,1
255,207,223,-48,-32,0.4251144893813916,0.4412117181615891,0.1336737924570194,0.4190776379019208,0.46876274694832,0.11215961514975913,1,0,2,1,2,1,0
434,321,367,-113,-67,0.2513681764473424,0.5902345291303962,0.15839729442226175,0.38289250287685395,0.5049985964959375,0.11210890062720849,0,0,1,3,0,1,0
301,135,271,-166,-30,0.5304810141803343,0.3506059256303023,0.11891306018936333,0.5098478415353731,0.3745075995923064,0.11564455887232049,0,1,1,1,1,1,0
277,210,257,-67,-20,0.5141817438491658,0.3812624869452228,0.10455576920561142,0.5011478683420482,0.38923066049677435,0.10962147116117749,1,0,1,1,2,1,0
454,331,444,-123,-10,0.30143301547928936,0.5764816673996309,0.12208531712107955,0.5330186448758918,0.3548071388199074,0.11217421630420119,0,0,1,3,0,1,0
334,225,246,-109,-88,0.3801309271552858,0.5137070066620194,0.10616206618269468,0.4218954984754974,0.4646822886653843,0.11342221285911828,0,1,2,2,1,1,0
353,367,521,14,168,0.2613007637294747,0.5932201294751813,0.14547910679534432,0.4778865993500396,0.3936531472915279,0.12846025335843259,1,0,1,1,2,0,1
234,177,249,-57,15,0.4228990163866644,0.4678784797986261,0.10922250381470931,0.48745412210322986,0.4004615917416991,0.11208428615507098,1,0,1,3,2,0,0
388,361,405,-27,17,0.4345974850261556,0.441559130207817,0.12384338476602744,0.43449759894237383,0.4569102992926019,0.10859210176502415,1,0,1,1,2,0,0
334,279,306,-55,-28,0.3663526067694854,0.498503129008222,0.13514426422229253,0.4494406784656709,0.4396639402884381,0.11089538124589092,1,0,2,1,2,1,0
278,185,234,-93,-44,0.4373344420078027,0.40040301920622223,0.162262538785975,0.43942394425677384,0.4508720220397373,0.10970403370348865,0,0,1,1,0,1,0
316,236,289,-80,-27,0.49491304820741217,0.40566058604594735,0.0994263657466403,0.40725916137524376,0.4809493211356229,0.1117915174891334,1,1,3,1,4,1,0
381,213,300,-168,-81,0.3897862598940152,0.4814558673528497,0.1287578727531348,0.4176590497217179,0.4514829393589186,0.13085801091936364,0,1,1,1,1,1,0
491,371,431,-120,-60,0.45638375365470546,0.4182829075942518,0.12533333875104272,0.45142204141624165,0.43828591987524085,0.1102920387085176,1,1,1,1,4,1,0
477,509,628,32,151,0.42959818322544646,0.4490386502793414,0.12136316649521213,0.4893695231221171,0.394017212671434,0.11661326420644862,1,1,2,1,4,0,1
343,268,312,-75,-31,0.4858072120437015,0.39683766832956807,0.1173551196267304,0.4729344263202736,0.41601459728304785,0.11105097639667842,1,0,1,1,2,1,0
233,107,216,-126,-17,0.4412685065474453,0.4320395009546928,0.12669199249786198,0.40641700527135305,0.48299673615554184,0.11058625857310515,1,0,1,1,2,1,0
363,428,440,65,77,0.34080639568275983,0.5444050548225237,0.11478854949471626,0.43466081019928215,0.4571984281842832,0.1081407616164346,1,1,1,2,4,0,1
411,241,383,-170,-28,0.31649600799558647,0.5589733517699039,0.12453064023450981,0.5040460417307906,0.37910148465907545,0.11685247361013389,1,1,2,1,4,1,0
315,266,291,-49,-24,0.4125438645163631,0.4624534812882235,0.12500265419541315,0.48402747457026624,0.39165232134399924,0.12432020408573466,0,0,1,1,0,1,0
312,210,379,-102,67,0.5016054551176106,0.39362112560894796,0.10477341927344133,0.4731605439574782,0.41379363631978433,0.1130458197227376,0,1,1,3,1,0,0
304,207,260,-97,-44,0.561159229963767,0.3367998201122148,0.10204094992401817,0.4788558683902323,0.4044339651966416,0.11671016641312615,1,1,3,1,4,1,0
386,231,297,-155,-89,0.49814529914578015,0.3825304584373331,0.11932424241688674,0.39814335077573837,0.490761344534957,0.11109530468930474,0,1,2,2,1,1,0
384,293,344,-91,-40,0.3547346246924914,0.5330345705895128,0.11223080471799571,0.49967933194730363,0.3844493367007641,0.11587133135193248,1,1,1,2,4,1,0
340,231,319,-109,-21,0.33251560770991223,0.5447649809032462,0.12271941138684164,0.371184909251646,0.5158438868419762,0.11297120390637788,1,1,2,1,4,1,0
261,188,231,-73,-30,0.40148781363611713,0.4789567875627328,0.11955539880115013,0.4378028509685306,0.44242421069605214,0.11977293833541716,1,0,2,1,2,1,0
470,482,529,12,59,0.4129708334580816,0.4445107406990646,0.1425184258428536,0.5383430483594541,0.3434077926241338,0.11824915901641221,1,0,4,2,2,0,1
250,157,188,-93,-62,0.4584692461404903,0.4358904846342637,0.10564026922524593,0.4448957799550154,0.44307591322479534,0.11202830682018917,1,0,1,2,2,1,0
270,190,220,-80,-50,0.34456091391738247,0.5317553169313448,0.12368376915127277,0.42631299684271007,0.4623981995888521,0.11128880356843758,0,1,1,2,1,1,0
368,340,360,-28,-8,0.3034101477088766,0.5845101848078345,0.1120796674832891,0.49097748547307635,0.3934142606726602,0.11560825385426371,1,0,1,1,2,1,0
392,290,324,-102,-68,0.4344379024833193,0.4334201942128652,0.1321419033038154,0.41470755517665164,0.475812492191916,0.10947995263143248,1,0,1,2,3,1,0
274,225,234,-49,-40,0.38316322754332405,0.5129753408041124,0.10386143165256348,0.43653879527548917,0.45554171581771136,0.10791948890679953,0,1,2,1,1,1,0
420,469,492,49,72,0.3963382533573634,0.5043298507237771,0.09933189591885948,0.5255128656670971,0.3539094126723659,0.12057772166053692,1,0,4,1,2,0,1
352,0,85,-352,-267,0.48051082511549614,0.40316103684977356,0.11632813803473058,0.5218528975535119,0.3664515599335343,0.1116955425129536,1,1,1,1,4,1,0
294,135,162,-159,-132,0.4111345624424573,0.49293156780094943,0.09593386975659338,0.437367472963664,0.4523644945867816,0.11026803244955471,0,0,1,1,0,1,0
469,481,585,12,116,0.33650410170444767,0.5448372225191702,0.11865867577638174,0.43763434622775077,0.43469883209076843,0.1276668216814808,1,1,1,1,4,0,1
367,199,227,-168,-140,0.3962327946060704,0.48196917616754986,0.12179802922637939,0.4623226837550723,0.42138973029358934,0.11628758595133837,0,0,1,1,0,1,0
160,176,198,16,38,0.4437747307580714,0.4341130372487647,0.12211223199316401,0.43060420852613607,0.45820969935387507,0.11118609211998887,0,0,2,1,0,0,1
409,343,390,-66,-19,0.4313833019641891,0.4531792116048561,0.11543748643095451,0.5405792406911984,0.3445160032014209,0.11490475610738075,1,0,2,1,2,1,0
329,296,319,-33,-10,0.5001958498093994,0.384842501427858,0.11496164876274258,0.4591507591519969,0.4290089511868836,0.11184028966111927,1,0,2,3,2,1,0
300,153,191,-147,-109,0.36178314053731186,0.5275304123983,0.11068644706438789,0.5412956777005257,0.3427788529991719,0.11592546930030255,1,1,2,1,4,1,0
272,204,226,-68,-46,0.29155484530880665,0.5840459634544218,0.12439919123677151,0.4223099831462324,0.4665618622045458,0.11112815464922214,1,0,1,1,2,1,0
318,233,282,-85,-36,0.4605263569620403,0.4132736669859544,0.12619997605200517,0.42858433996495204,0.44502575389225413,0.12638990614279386,1,1,5,2,4,1,0
321,340,437,19,116,0.46426035440056274,0.38838437910464013,0.1473552664947969,0.521868906370139,0.368123948862094,0.11000714476776684,1,1,2,1,4,0,1
368,213,283,-155,-85,0.29794442118999953,0.5979618361322019,0.10409374267779856,0.450765354863586,0.4322025115658634,0.11703213357055076,0,0,2,1,0,1,0
268,140,148,-128,-120,0.4738731553590953,0.4077225045679193,0.11840434007298525,0.45735788818619727,0.4174980704751072,0.12514404133869567,1,1,1,1,4,1,0
279,183,194,-96,-85,0.5263465874397646,0.3581376821233473,0.11551573043688802,0.5277171438143319,0.3419897028402798,0.13029315334538838,0,1,1,1,1,1,0
268,285,315,17,47,0.3622596613323543,0.5200044297126021,0.11773590895504371,0.5275031230440348,0.3524859174761691,0.12001095947979597,0,0,3,3,0,0,1
236,202,220,-34,-16,0.44180317966269705,0.45786134084251345,0.10033547949478959,0.4369709880282956,0.44695252660303725,0.11607648536866719,1,0,2,1,2,1,0
320,148,262,-172,-58,0.4616570473770681,0.42453094470044384,0.113812007922488,0.446754442074638,0.43909565672148554,0.1141499012038765,0,1,1,1,1,1,0
459,267,379,-192,-80,0.43376278590210404,0.46597635104270907,0.10026086305518687,0.45797038444241733,0.4315043698839838,0.110525245673599,1,0,3,1,2,1,0
287,305,373,18,86,0.42810894390413295,0.43331328377119305,0.1385777723246742,0.3358589351362891,0.5551847187769661,0.10895634608674466,1,1,2,1,4,0,1
343,236,310,-107,-33,0.44686623408277054,0.44033913480946874,0.11279463110776075,0.33076265378139724,0.556549603360488,0.1126877428581148,1,1,1,3,4,1,0
303,274,288,-29,-15,0.4236097533172221,0.4639791877653629,0.11241105891741472,0.4232072226341464,0.46379298649719847,0.11299979086865494,1,0,1,2,2,1,0
429,224,329,-205,-100,0.4427903676150712,0.42918633972880454,0.1280232926561244,0.4280259469975799,0.46095543156515206,0.11101862143726786,1,0,1,2,2,1,0
373,240,280,-133,-93,0.3821717487155301,0.48955597621690283,0.12827227506756686,0.4779010319624268,0.3954643644385326,0.1266346035990406,1,0,1,1,2,1,0
354,213,235,-141,-119,0.4287766168554653,0.45649036874785365,0.11473301439668102,0.3575938581528596,0.5318951665119483,0.11051097533519198,0,0,3,1,0,1,0
277,288,359,11,82,0.32761691292292516,0.5345104847562497,0.13787260232082532,0.34664722957135313,0.5467004843141514,0.10665228611449577,1,1,1,1,4,0,1
160,28,99,-132,-61,0.5104752502753093,0.3833912726106006,0.10613347711408995,0.44492133810155693,0.44256824697768465,0.11251041492075858,0,1,1,1,1,1,0
414,172,208,-242,-206,0.3908979826889831,0.48696138603227407,0.12214063127874279,0.4887135804050952,0.39352135876354927,0.1177650608313555,0,0,2,1,0,1,0
276,307,327,31,51,0.333047151275063,0.5465780523326469,0.12037479639229016,0.47836164550356286,0.4082195882348846,0.1134187662615524,0,0,2,1,0,0,1
599,269,425,-330,-174,0.44507229776293084,0.4318938013792153,0.12303390085785375,0.5393658465821677,0.3444652859740083,0.11616886744382436,0,1,1,1,1,1,0
334,249,317,-85,-17,0.4162050070326675,0.46896267673338565,0.11483231623394717,0.35797065448289916,0.5315070105712285,0.11052233494587195,0,1,1,1,1,1,0
289,138,238,-151,-51,0.41317845551255505,0.4688203996173817,0.11800114487006298,0.4968011725626678,0.37862378788989937,0.12457503954743275,1,1,1,2,4,1,0
254,283,305,29,51,0.5459040499216563,0.3479549121511596,0.10614103792718393,0.4447411253498984,0.44297606785476207,0.11228280679533954,0,1,2,3,1,0,1
239,141,212,-98,-27,0.4783939937105651,0.4243566591102812,0.0972493471791538,0.45914190373171304,0.4270687081331768,0.11378938813510996,1,0,1,1,3,1,0
349,368,400,19,51,0.4233887839919225,0.4324782737685886,0.14413294223948878,0.47269867143767014,0.41261093115217085,0.11469039741015907,0,0,2,3,0,0,1
344,225,238,-119,-106,0.37536214123139994,0.48780981570848436,0.13682804306011598,0.3943881038437711,0.4951188727714446,0.1104930233847841,0,0,1,2,0,1,0
442,290,315,-152,-127,0.30639075653228465,0.5902297222034062,0.1033795212643087,0.37283890116988244,0.5159521165654042,0.11120898226471354,1,0,2,3,2,1,0
407,427,460,20,53,0.3541014263689377,0.5046905218333587,0.14120805179770352,0.5400335177898864,0.34643686786262823,0.11352961434748524,1,0,5,1,2,0,1
400,251,323,-149,-77,0.3443279036176884,0.5285132223925282,0.12715887398978346,0.4879283557225368,0.3994617220059668,0.11260992227149612,0,0,1,1,0,1,0
254,192,225,-62,-29,0.5456006011980655,0.33150546432906813,0.12289393447286646,0.45371348171997855,0.4248901567380896,0.12139636154193159,0,1,1,1,1,1,0
350,241,258,-109,-92,0.377144176978407,0.5116798921420559,0.11117593087953713,0.4339539494997359,0.45323273002701314,0.11281332047325074,1,1,2,1,4,1,0
347,208,325,-139,-22,0.4166710223658543,0.4602080936855769,0.12312088394856882,0.49996787955738237,0.38338433000280114,0.1166477904398162,0,0,2,1,0,1,0
278,234,257,-44,-21,0.3669080384335293,0.5193192931464575,0.11377266842001287,0.4241170868535094,0.4641429216387685,0.11173999150772201,0,1,1,1,1,1,0
265,187,217,-78,-48,0.412040504453865,0.46894647938624856,0.1190130161598864,0.46990967587574195,0.41557411155172025,0.1145162125725375,1,1,1,1,4,1,0
349,361,423,12,74,0.2880316858418547,0.5904486799395084,0.12151963421863668,0.354771930780893,0.5347093585060502,0.11051871071305701,0,0,1,2,0,0,1
484,417,435,-67,-49,0.3069611304947476,0.5676101673824204,0.1254287021228321,0.4214133609981057,0.46988173166123626,0.10870490734065817,1,0,2,1,2,1,0
269,247,281,-22,12,0.4756834666990004,0.41755077829209225,0.1067657550089073,0.3890711650961624,0.5012435093412323,0.10968532556260534,1,0,1,1,2,0,0
352,208,292,-144,-60,0.4972728021982097,0.39765118219455914,0.10507601560723134,0.5407373884991966,0.3401174643057516,0.1191451471950518,1,0,1,1,2,1,0
403,260,373,-143,-30,0.44111797169907546,0.44364506886344907,0.1152369594374753,0.4654467914258792,0.42433277446922774,0.11022043410489318,1,0,2,2,3,1,0
245,196,218,-49,-27,0.43298140046737804,0.4521378072146394,0.1148807923179824,0.4633689990518655,0.42166012017299204,0.1149708807751426,1,0,2,1,2,1,0
307,253,268,-54,-39,0.38072884745034824,0.490178922406918,0.12909223014273385,0.3977270119079636,0.49037564525734484,0.11189734283469162,1,0,1,1,2,1,0
214,236,291,22,77,0.3413948744933038,0.5522335708820671,0.1063715546246293,0.4100453026325489,0.47814391469778716,0.11181078266966356,1,1,1,2,4,0,1
306,284,295,-22,-11,0.49671243032967305,0.39198307845460834,0.11130449121571871,0.4670385586063001,0.4227354511092857,0.11022599028441431,0,1,2,1,1,1,0
357,45,311,-312,-46,0.5046185379764574,0.38497618019578195,0.1104052818277609,0.4447960869387069,0.44200887108444425,0.11319504197684871,1,0,1,1,2,1,0
354,211,341,-143,-13,0.3473572652786701,0.5435066210497206,0.10913611367160947,0.47317853898401174,0.41255238001105693,0.11426908100493144,0,0,3,1,0,1,0
274,250,264,-24,-10,0.479022585089203,0.4240053269901417,0.09697208792065547,0.5012726102943633,0.38516243911707704,0.11356495058855963,1,0,1,1,3,1,0
333,260,297,-73,-36,0.4977536016027307,0.37680837379744275,0.1254380245998267,0.4867184373686333,0.3965801307813797,0.11670143184998702,1,0,1,1,2,1,0
250,156,299,-94,49,0.4892033608598916,0.3756510712760478,0.13514556786406054,0.45177944351254473,0.43120047646066023,0.1170200800267952,0,1,2,2,1,0,0
347,312,361,-35,14,0.49892002429307786,0.37577713452562483,0.12530284118129734,0.37346509110258136,0.5169088509350145,0.10962605796240438,1,1,1,1,4,0,0
283,147,209,-136,-74,0.5046185379764574,0.38497618019578195,0.1104052818277609,0.4447960869387069,0.44200887108444425,0.11319504197684871,1,0,2,1,2,1,0
326,203,300,-123,-26,0.46792534013879145,0.3922279643653837,0.13984669549582476,0.4491178044683106,0.4387664681426529,0.11211572738903632,1,0,1,1,3,1,0
300,164,223,-136,-77,0.3402379596688511,0.5212598175618435,0.13850222276930507,0.4748444071399046,0.4056974608486367,0.11945813201145881,1,1,2,2,4,1,0
365,130,186,-235,-179,0.32091460373674807,0.5420266913701274,0.13705870489312466,0.5092756362009916,0.37502422909758654,0.11570013470142176,0,0,1,1,0,1,0
315,92,183,-223,-132,0.45367400926239454,0.4039247791633689,0.1424012115742365,0.41840147062656835,0.4635821451900716,0.11801638418336009,1,0,1,1,2,1,0
340,276,293,-64,-47,0.5552421237904079,0.3302777984424485,0.11448007776714357,0.48948620786693553,0.3937416649216291,0.11677212721143514,1,0,1,2,2,1,0
269,214,257,-55,-12,0.3489085182863339,0.5489439076230095,0.10214757409065647,0.3755733090121949,0.5115239455153516,0.11290274547245348,0,0,2,1,0,1,0
276,104,291,-172,15,0.4100022379239916,0.4491726853589873,0.1408250767170212,0.4486582695601542,0.4257246300278885,0.12561710041195723,1,0,1,1,2,0,0
368,257,308,-111,-60,0.4148530301361281,0.4657246316298441,0.11942233823402747,0.5050644985378695,0.378439955702334,0.11649554575979655,1,0,3,1,2,1,0
426,283,359,-143,-67,0.41839893649962523,0.47371583982466364,0.10788522367571081,0.538145759093887,0.3474670681917597,0.11438717271435338,1,0,1,1,3,1,0
410,336,381,-74,-29,0.5037391028018918,0.40208948999664773,0.09417140720146049,0.41019704397260054,0.47516574389964283,0.11463721212775675,1,0,1,1,2,1,0
396,261,290,-135,-106,0.4333826511553248,0.43384825035026775,0.1327690984944074,0.5242702114423509,0.36329558243176674,0.1124342061258826,1,0,3,1,2,1,0
238,249,259,11,21,0.4071767580641337,0.4819254352181269,0.11089780671773895,0.5004558393743604,0.38130818430409286,0.1182359763215465,0,0,4,5,0,0,1
464,372,383,-92,-81,0.33357641420078354,0.5214927651795479,0.14493082061966855,0.501163269705726,0.3814364625732419,0.11740026772103224,0,0,3,1,0,1,0
410,423,625,13,215,0.3418300020578216,0.5229865593295514,0.13518343861262708,0.4580618992594339,0.41987393038005527,0.1220641703605109,1,1,2,1,4,0,1
619,636,667,17,48,0.36764685271080016,0.48444772363094607,0.14790542365825368,0.5052026371688846,0.3742795297041961,0.12051783312691915,1,1,3,3,4,0,1
332,129,307,-203,-25,0.5510568792893449,0.353763461379143,0.09517965933151222,0.5406859146563429,0.3448899269589142,0.1144241583847428,0,0,2,1,0,1,0
312,159,216,-153,-96,0.33007422980504414,0.5619584052705363,0.10796736492441922,0.3752559515840033,0.5102931079416096,0.11445094047438674,0,0,3,1,0,1,0
418,295,443,-123,25,0.40747412439472175,0.4545475693915845,0.13797830621369356,0.49658237699224617,0.3781084380537185,0.12530918495403526,1,1,1,1,4,0,0
243,102,130,-141,-113,0.5168845657335419,0.3705534395930219,0.11256199467343635,0.488655580019886,0.3979659836953316,0.11337843628478247,1,1,1,1,4,1,0
389,246,342,-143,-47,0.34455530796073947,0.545700116786982,0.10974457525227833,0.4141467309133812,0.4647392560081398,0.12111401307847884,1,1,2,1,4,1,0
259,176,195,-83,-64,0.5425986640565458,0.3520438078053983,0.10535752813805575,0.5213761338327542,0.36596878841851355,0.1126550777487323,0,1,2,1,1,1,0
149,0,50,-149,-99,0.44409461774361225,0.4432195081091578,0.11268587414722979,0.5054024438749825,0.37634637287707506,0.1182511832479424,0,0,1,1,0,1,0
455,281,416,-174,-39,0.4640900611224065,0.40932104228157307,0.12658889659602043,0.40715500791716214,0.4810539170728552,0.11179107500998264,1,0,1,1,2,1,0
266,180,231,-86,-35,0.40787567330240954,0.4512183027698569,0.14090602392773383,0.512498560504704,0.37278624267838784,0.11471519681690845,1,0,2,1,2,1,0
375,237,430,-138,55,0.4662376042070759,0.4198925739431919,0.1138698218497324,0.49893871535375633,0.37614536031059737,0.12491592433564648,1,0,1,1,2,0,0
284,172,212,-112,-72,0.4475916182902176,0.42217047696984783,0.13023790473993466,0.441473464307294,0.44530284847257645,0.11322368722012936,0,0,1,1,0,1,0
296,377,428,81,132,0.35581765897499207,0.5192559504380868,0.12492639058692102,0.4792259806350088,0.40298028216832366,0.11779373719666755,1,0,1,2,2,0,1
298,233,275,-65,-23,0.4653367498149491,0.4286976091893391,0.10596564099571144,0.41950354639125365,0.47214643686265295,0.10835001674609335,1,0,2,1,2,1,0
337,298,314,-39,-23,0.4227460043015724,0.46298593290536166,0.11426806279306602,0.43347255065011764,0.4487731439446933,0.11775430540518925,0,1,1,1,1,1,0
322,353,444,31,122,0.4410948312045166,0.4524772804342513,0.1064278883612319,0.49152737151349496,0.3945378883085538,0.11393474017795122,0,0,1,1,0,0,1
421,300,354,-121,-67,0.2652091445204701,0.5976017941650897,0.1371890613144399,0.3221624116790659,0.5668123065844721,0.11102528173646214,0,0,1,2,0,1,0
417,374,390,-43,-27,0.4785010205250246,0.4019299126776339,0.11956906679734165,0.44338695299209746,0.4468922146669549,0.10972083234094757,0,0,1,1,0,1,0
358,324,347,-34,-11,0.4221197182801019,0.4709882770191768,0.10689200470072117,0.41908127865619005,0.4701042502593522,0.11081447108445792,0,0,1,4,0,1,0
262,116,138,-146,-124,0.4809163660076765,0.4069127128453299,0.11217092114699377,0.5073610722689567,0.3778486103334029,0.11479031739764027,0,1,3,1,1,1,0
308,178,222,-130,-86,0.45704533499369143,0.40747641491786135,0.13547825008844727,0.41674883370803767,0.47354385531296833,0.10970731097899392,0,0,2,1,0,1,0
315,233,344,-82,29,0.4429404218321792,0.43586546518562663,0.12119411298219421,0.49995199329257023,0.38836301856559147,0.11168498814183841,1,1,1,3,4,0,0
282,263,275,-19,-7,0.46334965378687065,0.4150607443899666,0.12158960182316243,0.44752459788147025,0.434313747981006,0.1181616541375236,1,1,4,1,4,1,0
314,354,388,40,74,0.3171614466463666,0.5453519290053255,0.13748662434830755,0.4001433920994637,0.4894215940342344,0.11043501386630158,1,1,1,5,4,0,1
327,272,304,-55,-23,0.542273340909011,0.3448340075791748,0.11289265151181424,0.5205458712712864,0.36553239827319023,0.11392173045552348,1,0,1,1,2,1,0
285,80,126,-205,-159,0.41620585329834864,0.473324494198774,0.11046965250287744,0.4988827610882858,0.3863429036150719,0.11477433529664227,1,0,1,1,2,1,0
355,387,416,32,61,0.33255948056678225,0.495741188918238,0.17169933051497982,0.4318288026851081,0.4397225813276554,0.12844861598723661,1,0,2,1,2,0,1
281,0,59,-281,-222,0.4562803931308847,0.4273861755095867,0.11633343135952819,0.445575364961123,0.4342444256756696,0.12018020936320742,0,1,1,1,1,1,0
319,140,332,-179,13,0.45078921450233733,0.4301519988648464,0.11905878663281642,0.45682222937011785,0.4300976311125854,0.11308013951729676,1,0,2,1,2,0,0
217,178,187,-39,-30,0.44223175922426344,0.43370149730244356,0.12406674347329304,0.4388810660343979,0.44554037190479145,0.11557856206081062,1,0,3,2,3,1,0
290,300,349,10,59,0.42770192520645517,0.470581547558209,0.10171652723533553,0.4416224595776871,0.4373191088736394,0.12105843154867331,1,0,4,2,2,0,1
257,144,216,-113,-41,0.4781836623311046,0.3971330396816074,0.12468329798728817,0.4417032495886237,0.44460346419158947,0.11369328621978671,1,0,1,2,3,1,0
306,244,272,-62,-34,0.49379333686920923,0.3845186907038957,0.12168797242689508,0.47732389264641467,0.40614331924653835,0.11653278810704712,1,0,2,2,2,1,0
327,265,347,-62,20,0.40168956760858676,0.48103365099468026,0.1172767813967326,0.505814210679764,0.38533314216080833,0.10885264715942773,1,0,2,1,2,0,0
243,200,226,-43,-17,0.3464769910518502,0.5266420764460799,0.12688093250206994,0.46400873291291955,0.41900161522739243,0.11698965185968789,0,1,2,3,1,1,0
263,235,256,-28,-7,0.38462160797753314,0.5099306400570163,0.10544775196545061,0.4517072641196785,0.4292546062929961,0.11903812958732556,1,1,1,1,4,1,0
757,535,689,-222,-68,0.40694860762836293,0.4742216464576696,0.11882974591396737,0.5380141928282433,0.34379232619362093,0.11819348097813587,0,1,1,1,1,1,0
487,395,476,-92,-11,0.4041375006897374,0.4892010366348635,0.10666146267539914,0.3921518545589292,0.4981393186148204,0.10970882682625036,1,0,3,3,2,1,0
93,26,50,-67,-43,0.3990023442728942,0.4917442096213464,0.1092534461057595,0.41775558874203617,0.4600212913061382,0.12222311995182555,0,1,3,2,1,1,0
188,201,259,13,71,0.3973011144005766,0.4930864926897624,0.10961239290966064,0.4519339444256238,0.4374396673752768,0.11062638819909931,1,1,1,2,4,0,1
373,245,338,-128,-35,0.3832039238308854,0.4961632220041597,0.12063285416495495,0.5254975507772323,0.36027020792504044,0.11423224129772737,0,0,1,1,0,1,0
319,166,219,-153,-100,0.43364668233773,0.4103044960107172,0.15604882165155284,0.4990467831795728,0.3828927087170993,0.11806050810332781,1,0,1,1,2,1,0
417,402,431,-15,14,0.26496672713926994,0.6182043080769508,0.11682896478377919,0.28639283940843435,0.6083059754338397,0.10530118515772569,1,1,1,2,4,0,0
278,227,264,-51,-14,0.44560546954689734,0.4358105354423185,0.11858399501078393,0.5346836444695304,0.3520512710400984,0.11326508449037129,0,0,4,1,0,1,0
289,211,238,-78,-51,0.32640868278990914,0.5386061071866441,0.13498521002344643,0.3373751308922141,0.5519260178970794,0.11069885121070652,1,1,1,1,4,1,0
281,147,179,-134,-102,0.3525569708487715,0.5110483279227352,0.136394701228493,0.41751002644727137,0.4743085600289982,0.1081814135237301,0,1,1,2,1,1,0
387,251,268,-136,-119,0.4485120954069533,0.44132420976939873,0.110163694823648,0.49453485928748053,0.3929546585402423,0.11251048217227724,1,0,2,2,2,1,0
185,256,513,71,328,0.41958090436445,0.44712685942262936,0.1332922362129206,0.43539550998915866,0.44747472197524624,0.11712976803559493,1,1,1,1,4,0,1
471,447,492,-24,21,0.5058372610605665,0.38644090478525794,0.10772183415417542,0.41540232546148137,0.4714918786100936,0.11310579592842496,1,0,1,3,2,0,0
330,274,311,-56,-19,0.33766240095472677,0.5530714856039075,0.10926611344136532,0.44562193814777007,0.4468000276967722,0.10757803415545801,1,0,2,2,2,1,0
260,89,268,-171,8,0.46070141005584453,0.4072275795472487,0.1320710103969065,0.4525685579916667,0.43882598507069354,0.10860545693763952,1,0,3,1,2,0,0
275,149,245,-126,-30,0.35057273689776086,0.5268248888327297,0.12260237426950941,0.4821517805610221,0.40304436337886934,0.11480385606010877,1,0,1,1,2,1,0
280,214,241,-66,-39,0.511966288050506,0.3746139170882504,0.11341979486124376,0.43900844860526866,0.4488758367248507,0.1121157146698807,1,0,2,2,3,1,0
442,232,278,-210,-164,0.24821141192806184,0.5645627639175116,0.1872258241544269,0.43374613465488315,0.4329519734719026,0.1333018918732138,1,0,4,1,2,1,0
270,200,217,-70,-53,0.4308274760130776,0.46548142710449697,0.1036910968824256,0.5334408272310623,0.34818844549062794,0.11837072727830951,1,0,3,1,2,1,0
277,236,259,-41,-18,0.3441077362913975,0.5306862555924217,0.1252060081161807,0.4077169249629241,0.47933685510917934,0.11294621992789665,1,0,1,1,2,1,0
323,399,425,76,102,0.2744529155149987,0.6086679017425208,0.1168791827424805,0.3297974903454143,0.5616455573972906,0.10855695225729486,1,0,2,3,2,0,1
415,353,391,-62,-24,0.33050368951076925,0.5393219531745627,0.1301743573146682,0.40239981246698703,0.485249862000467,0.1123503255325459,1,1,1,1,4,1,0
348,197,267,-151,-81,0.40728610737658366,0.4824437349099421,0.11027015771347423,0.45244223115358645,0.4389912345064825,0.10856653433993106,1,0,2,1,2,1,0
300,162,189,-138,-111,0.40779736034060143,0.47618956427209524,0.11601307538730339,0.522846221918577,0.36316005453413397,0.11399372354728918,0,0,2,1,0,1,0
311,329,404,18,93,0.30829832900271004,0.5774286359691796,0.11427303502811045,0.4570072165670816,0.4310526560310908,0.11194012740182725,1,0,1,1,2,0,1
338,285,313,-53,-25,0.4411098690825284,0.4358791565434031,0.12301097437406848,0.39897390546851186,0.4894016321980091,0.1116244623334789,1,0,1,2,2,1,0
304,264,314,-40,10,0.4026045576540913,0.477140339516214,0.12025510282969454,0.40659789461729473,0.48109077078953527,0.11231133459317003,1,1,1,3,4,0,0
664,488,605,-176,-59,0.44447118177539613,0.4259220625197105,0.1296067557048936,0.540740517194041,0.34234000239975027,0.1169194804062086,0,0,3,5,0,1,0
504,433,452,-71,-52,0.15588414927777844,0.7275306405752994,0.1165852101469223,0.32071057071673303,0.5666656084848233,0.11262382079844349,1,0,1,1,3,1,0
350,282,339,-68,-11,0.39837695723176514,0.48347142501189316,0.11815161775634182,0.49926042120695563,0.3838757997171899,0.11686377907585441,0,1,3,1,1,1,0
294,251,275,-43,-19,0.40592707940463,0.4875206326051339,0.10655228799023618,0.39136014576310224,0.4968447566270636,0.11179509760983436,0,0,1,2,0,1,0
309,119,195,-190,-114,0.4514399418935856,0.44879918519151846,0.09976087291489598,0.460056595181378,0.41316006922327303,0.12678333559534896,1,1,1,2,4,1,0
387,338,373,-49,-14,0.286519846736623,0.6040169674969836,0.10946318576639363,0.4126557026540274,0.47733942826886394,0.11000486907710876,1,1,1,1,4,1,0
324,280,301,-44,-23,0.40790628144889995,0.4869988197672062,0.10509489878389372,0.4593121233802384,0.42771330906202976,0.11297456755773172,1,1,1,1,4,1,0
305,172,258,-133,-47,0.5475226527205004,0.3518933464067113,0.1005840008727886,0.45886001248171165,0.4272314773052898,0.11390851021299864,1,1,1,1,4,1,0
284,222,261,-62,-23,0.44540523790351827,0.4459955467093807,0.10859921538710092,0.38089512593311625,0.5071757736695053,0.11192910039737858,1,0,1,3,2,1,0
266,302,367,36,101,0.4377232402571352,0.4526395374460737,0.1096372222967911,0.44954989549114577,0.4404054753681934,0.11004462914066047,1,0,1,2,2,0,1
3,51,71,48,68,0.5046185379764574,0.38497618019578195,0.1104052818277609,0.4447960869387069,0.44200887108444425,0.11319504197684871,1,1,1,1,4,0,1
255,51,71,-204,-184,0.30439579341908507,0.5754601617367527,0.12014404484416252,0.35865698654577266,0.5299064267714158,0.11143658668281144,0,1,1,2,1,1,0
262,171,184,-91,-78,0.47904720476626284,0.40116102429096023,0.11979177094277675,0.49832893142692336,0.3893846157229076,0.112286452850169,1,1,3,1,4,1,0
409,289,345,-120,-64,0.2479977867286182,0.6196904894622792,0.13231172380910236,0.32492654092030626,0.5635270691030925,0.11154638997660091,0,1,1,2,1,1,0
275,187,311,-88,36,0.4177237620945784,0.4596185485158479,0.12265768938957386,0.4772977086086668,0.39319844263342707,0.1295038487579058,0,0,1,1,0,0,0
347,407,443,60,96,0.4823219120395294,0.39665019895766207,0.12102788900280859,0.5195610964916811,0.36748268319800453,0.11295622031031445,1,0,1,2,2,0,1
439,172,333,-267,-106,0.5046185379764574,0.38497618019578195,0.1104052818277609,0.4447960869387069,0.44200887108444425,0.11319504197684871,1,1,1,1,4,1,0
332,298,319,-34,-13,0.47953662508782574,0.40591272252288524,0.11455065238928917,0.40671427330592347,0.4798313114311628,0.11345441526291351,0,1,3,4,1,1,0
274,298,319,24,45,0.47953662508782574,0.40591272252288524,0.11455065238928917,0.40671427330592347,0.4798313114311628,0.11345441526291351,1,1,3,4,4,0,1
253,145,326,-108,73,0.48429297418964046,0.4059533020988546,0.10975372371150496,0.5054364951338002,0.38519155637749697,0.10937194848870273,0,0,1,1,0,0,0
189,42,68,-147,-121,0.510094859902617,0.38132952797379127,0.10857561212359133,0.45623323496003726,0.43113589495492366,0.112630870085039,1,0,3,1,2,1,0
242,68,129,-174,-113,0.45746566423976814,0.4182721993158168,0.12426213644441507,0.46553189270361156,0.41216103935639675,0.12230706793999153,0,0,1,1,0,1,0
406,438,494,32,88,0.3642209539924583,0.5268251658611977,0.10895388014634405,0.4425681626750597,0.44603787079777196,0.11139396652716844,1,1,3,1,4,0,1
328,157,171,-171,-157,0.40691572958631084,0.4932275375422031,0.09985673287148601,0.42978087055567626,0.4609183870189233,0.10930074242540053,0,1,1,1,1,1,0
262,7,29,-255,-233,0.32982239833218646,0.5647733885559254,0.10540421311188823,0.36368324333423896,0.5248406870547268,0.11147606961103446,1,1,1,2,4,1,0
345,244,306,-101,-39,0.46307612921848407,0.3987221425890018,0.13820172819251414,0.42784419969873155,0.4359973446428688,0.1361584556583996,1,0,1,1,2,1,0
292,195,281,-97,-11,0.46647509642749635,0.4130456819550765,0.12047922161742726,0.5244738224503035,0.3572154130787146,0.1183107644709818,0,0,1,1,0,1,0
371,382,408,11,37,0.4673710477337439,0.41692999876717063,0.1156989534990856,0.39530453774597984,0.49231570149747256,0.11237976075654763,1,1,1,3,4,0,1
344,290,308,-54,-36,0.432625971574803,0.4381546877254108,0.12921934069978627,0.38952228488666096,0.49675921902041237,0.11371849609292632,1,0,2,2,2,1,0
300,216,237,-84,-63,0.4142128372604009,0.46510782516610616,0.1206793375734928,0.4093360542827235,0.4813883623768867,0.10927558334038986,0,1,1,1,1,1,0
288,188,261,-100,-27,0.40320070393923557,0.49172512991867934,0.10507416614208473,0.4785268700275348,0.40361157943593434,0.11786155053653075,1,1,2,1,4,1,0
247,110,182,-137,-65,0.4523542330556932,0.4327862692607511,0.11485949768355558,0.4083632638892758,0.4795247205977302,0.11211201551299409,1,0,1,2,2,1,0
451,378,412,-73,-39,0.45744104630741983,0.44757200308103456,0.09498695061154586,0.4305437653078141,0.45737931331160586,0.11207692138058019,1,0,1,2,2,1,0
254,288,382,34,128,0.5048113324486924,0.35204990853377094,0.14313875901753653,0.4384590305066361,0.4391043691536315,0.12243660033973253,1,0,2,3,2,0,1
279,230,256,-49,-23,0.32346058262781063,0.5287213178539949,0.14781809951819438,0.4417365188484226,0.4337926252025318,0.12447085594904526,0,0,1,1,0,1,0
405,212,303,-193,-102,0.4503300126614057,0.42881117184160356,0.12085881549699061,0.4957449092307735,0.3858254967736202,0.11842959399560606,0,0,2,1,0,1,0
414,371,388,-43,-26,0.1887225646382416,0.698936570569218,0.11234086479254034,0.5074882837903308,0.38111780060657974,0.1113939156030897,0,1,2,1,1,1,0
466,529,569,63,103,0.33525382637672857,0.5451150433806637,0.11963113024260753,0.5413331302854747,0.34064814355099005,0.11801872616353513,0,0,3,1,0,0,1
274,163,197,-111,-77,0.4503432796148463,0.4333876920763751,0.11626902830877862,0.38604733075303127,0.5019688120931568,0.11198385715381186,1,0,3,3,2,1,0
351,174,302,-177,-49,0.4120793521151743,0.45602851964338326,0.13189212824144259,0.5297264583265104,0.3561241317067145,0.1141494099667751,0,0,1,1,0,1,0
412,431,454,19,42,0.49436623514905703,0.35064757080007686,0.15498619405086597,0.4749023619236921,0.39670269190452856,0.12839494617177924,1,0,3,3,2,0,1
286,224,243,-62,-43,0.38936799155831886,0.5031693668181564,0.10746264162352516,0.42089245703624045,0.46769343737627456,0.11141410558748505,1,1,1,2,4,1,0
287,214,276,-73,-11,0.4433871648857427,0.4542550011325758,0.10235783398168147,0.4702211990427005,0.41561915420658957,0.11415964675070966,0,1,2,1,1,1,0
319,179,405,-140,86,0.29737728352064435,0.5859375086396316,0.1166852078397243,0.4556591021089703,0.4313827770384207,0.11295812085260892,1,0,1,1,2,0,0
339,316,430,-23,91,0.3632771709773976,0.5113578346265044,0.12536499439609783,0.4336772541475862,0.45176436921035057,0.11455837664206317,1,0,2,1,2,0,0
373,281,348,-92,-25,0.43615908987945995,0.4239189791569297,0.13992193096361039,0.4732913940105132,0.41618811504334313,0.110520490946144,1,1,1,1,4,1,0
246,175,215,-71,-31,0.4290095548011296,0.45499154116700385,0.11599890403186665,0.4528845504007432,0.4362553459053508,0.1108601036939062,0,0,1,1,0,1,0
314,145,215,-169,-99,0.5046185379764574,0.38497618019578195,0.1104052818277609,0.4447960869387069,0.44200887108444425,0.11319504197684871,0,1,1,1,1,1,0
395,428,446,33,51,0.4721308431585203,0.4139115882665787,0.113957568574901,0.5050128856769717,0.380042116608417,0.11494499771461106,1,1,3,2,4,0,1
354,308,327,-46,-27,0.37810634250427866,0.49572111951327075,0.1261725379824505,0.42250806749026826,0.4665430287640721,0.11094890374565937,1,0,1,1,2,1,0
408,427,455,19,47,0.3829686905079496,0.521108507485467,0.09592280200658354,0.5206448882714757,0.36911412858347464,0.1102409831450498,1,0,3,1,2,0,1
388,410,420,22,32,0.4933735254295912,0.4084075688021077,0.09821890576830113,0.5184606067419592,0.3648730926069398,0.11666630065110102,1,0,2,1,2,0,1
318,245,278,-73,-40,0.4200428028269144,0.45821888598052674,0.12173831119255896,0.4485794240299866,0.43950130600306536,0.11191926996694791,1,1,3,3,4,1,0
305,265,277,-40,-28,0.4159485626978798,0.45867179912075084,0.12537963818136943,0.5060266693401685,0.3795334567245858,0.11443987393524584,0,1,4,5,1,1,0
388,333,437,-55,49,0.4593023992226818,0.41588486459470236,0.1248127361826158,0.4027145608675992,0.48560247997885175,0.11168295915354899,1,1,1,3,4,0,0
243,179,211,-64,-32,0.42592608580672264,0.4468710666443362,0.1272028475489413,0.4401205349971105,0.4403426075227123,0.11953685748017708,1,0,2,3,2,1,0
268,281,297,13,29,0.504705637813008,0.3792910961444972,0.1160032660424948,0.4207005414455451,0.4633516331773508,0.11594782537710414,1,0,1,1,2,0,1
498,328,386,-170,-112,0.41192303760134313,0.4807861248659472,0.10729083753270971,0.40164600576720916,0.48765555853744247,0.1106984356953484,0,1,2,2,1,1,0
378,334,353,-44,-25,0.2446053458131499,0.6329516197760002,0.12244303441084978,0.4199269107278513,0.46798872430485533,0.11208436496729329,1,1,2,1,4,1,0
290,305,360,15,70,0.475617847774145,0.39111653410558245,0.13326561812027232,0.4359460704273799,0.4538864636640878,0.11016746590853246,1,0,2,2,2,0,1
353,315,327,-38,-26,0.3885987171091103,0.4971765388495264,0.11422474404136308,0.48291308414046846,0.39147021135874466,0.125616704500787,0,1,1,2,1,1,0
392,408,452,16,60,0.41763793323109716,0.44918930994286754,0.13317275682603502,0.40676627856540465,0.4794596777522175,0.11377404368237787,1,1,2,2,4,0,1
360,300,384,-60,24,0.3406843665485031,0.5429931358809064,0.1163224975705908,0.41884923314086514,0.47213855185546755,0.10901221500366748,1,1,1,2,4,0,0
306,132,175,-174,-131,0.43958621154089467,0.45327331048986813,0.10714047796923705,0.4334702261685331,0.4445771529316814,0.12195262089978552,1,0,1,2,2,1,0
327,158,167,-169,-160,0.329135468869681,0.5416510771509482,0.12921345397937062,0.3857898482689494,0.5032952365937093,0.11091491513734116,1,0,1,1,2,1,0
123,0,31,-123,-92,0.4955390969352039,0.38811319263389954,0.11634771043089677,0.4609087562479908,0.4225782450432184,0.11651299870879057,0,0,1,2,0,1,0
265,201,238,-64,-27,0.5046185379764574,0.38497618019578195,0.1104052818277609,0.4447960869387069,0.44200887108444425,0.11319504197684871,1,0,1,1,2,1,0
467,277,387,-190,-80,0.23411460596346337,0.6333986712344695,0.13248672280206775,0.5392056819365378,0.34281358123500594,0.11798073682845603,0,1,1,1,1,1,0
390,292,307,-98,-83,0.26338516691634656,0.5772714350999486,0.15934339798370517,0.3972638128383368,0.49412637684274735,0.10860981031891591,0,1,1,2,1,1,0
268,131,183,-137,-85,0.37519823472475167,0.47873997793248496,0.14606178734276315,0.5411361121261075,0.34036982002199545,0.11849406785189695,0,0,1,1,0,1,0
241,151,225,-90,-16,0.4207303177853893,0.47622347775519785,0.10304620445941295,0.510254077725987,0.37482506571871893,0.11492085655529401,1,1,2,1,4,1,0
327,244,310,-83,-17,0.4685434996625453,0.41403811253482337,0.11741838780263122,0.446274299532593,0.44179339791016875,0.11193230255723806,1,0,1,1,2,1,0
132,0,122,-132,-10,0.5341222841905735,0.3564028004260135,0.10947491538341296,0.5084481792624987,0.37814943646180726,0.11340238427569392,0,0,1,1,0,1,0
303,244,287,-59,-16,0.3772733378465669,0.5019101678644184,0.12081649428901467,0.42114646487135443,0.47032727505182303,0.10852626007682253,1,1,1,1,4,1,0
363,465,602,102,239,0.5649799857148172,0.307519399969125,0.1275006143160579,0.5437740452516051,0.33717045912710175,0.11905549562129303,1,0,5,7,2,0,1
475,403,461,-72,-14,0.2977228064906596,0.5974045477318802,0.10487264577746028,0.5321291520268838,0.35135935195255225,0.1165114960205637,1,1,1,1,4,1,0
334,301,316,-33,-18,0.3338363898445425,0.568429910640722,0.09773369951473557,0.36192759419966514,0.5275019086250544,0.11057049717528034,0,1,1,2,1,1,0
302,285,295,-17,-7,0.4478035431410982,0.4419985004355619,0.1101979564233399,0.4966638092324913,0.38245599300448446,0.12088019776302408,0,0,1,2,0,1,0
303,204,364,-99,61,0.47084744349778035,0.39862636126057466,0.13052619524164488,0.496750166617455,0.3827809526678113,0.12046888071473352,1,0,3,1,2,0,0
273,195,225,-78,-48,0.3706383815816102,0.5052530614591466,0.12410855695924294,0.47838338853500295,0.41142741013562534,0.11018920132937146,0,1,1,1,1,1,0
300,231,268,-69,-32,0.4409996915697412,0.44474575245108816,0.11425455597917068,0.440122569613683,0.44946212292753457,0.11041530745878235,1,1,2,3,4,1,0
409,321,479,-88,70,0.3237812342973102,0.5363940237698468,0.13982474193284275,0.3936694040383055,0.4952954063092446,0.11103518965244974,1,0,1,3,2,0,0
261,180,233,-81,-28,0.45080726084754913,0.433771765967506,0.11542097318494501,0.5049211141952044,0.3780109466023562,0.11706793920243934,1,1,2,1,4,1,0
471,363,384,-108,-87,0.3419627753222725,0.5322312146091197,0.1258060100686077,0.3807387221944057,0.5107446009864671,0.10851667681912706,0,1,4,1,1,1,0
459,256,322,-203,-137,0.5075327322911942,0.3749649442814346,0.11750232342737096,0.5405929115069441,0.3436634846778405,0.11574360381521526,0,0,2,1,0,1,0
501,397,460,-104,-41,0.4846075822496113,0.354550565775658,0.16084185197473058,0.5395696985059928,0.34492225922151304,0.1155080422724941,0,0,2,4,0,1,0
275,307,351,32,76,0.413260337827273,0.46732241528580226,0.11941724688692504,0.45080385104392834,0.4359269988166776,0.11326915013939395,1,0,2,1,2,0,1
520,457,466,-63,-54,0.343630894053842,0.5237834331180683,0.13258567282808975,0.4968357053130783,0.3895266624063809,0.11363763228054048,1,0,4,1,2,1,0
335,269,320,-66,-15,0.41741116496425895,0.4724717310269328,0.11011710400880838,0.512012229190917,0.36479461084863835,0.12319315996044435,0,1,3,1,1,1,0
130,4,71,-126,-59,0.46373547694972395,0.40935208295016995,0.12691244010010602,0.455490111032542,0.4312785772688071,0.11323131169865103,1,0,2,1,2,1,0
467,387,410,-80,-57,0.4404707619432842,0.4358041166651494,0.12372512139156619,0.39712096479932957,0.4904641736166029,0.11241486158406734,1,0,1,2,2,1,0
307,262,275,-45,-32,0.4884565164699214,0.41009333527287134,0.10145014825720713,0.45539940284317887,0.43246863982575845,0.1121319573310626,1,1,2,2,4,1,0
144,0,34,-144,-110,0.5046185379764574,0.38497618019578195,0.1104052818277609,0.4447960869387069,0.44200887108444425,0.11319504197684871,1,1,1,1,4,1,0
384,287,307,-97,-77,0.3538925028169323,0.5333177606988551,0.11278973648421241,0.3916334188498869,0.4974651552084256,0.11090142594168777,1,0,2,1,2,1,0
220,180,202,-40,-18,0.45368769646319673,0.4307913966017859,0.11552090693501747,0.5228639051229176,0.3645215480787051,0.11261454679837711,1,0,1,4,2,1,0
396,189,347,-207,-49,0.5397327411059889,0.3546192066375293,0.1056480522564818,0.5404096762590225,0.3397210064000071,0.11986931734097055,0,1,1,1,1,1,0
375,296,340,-79,-35,0.43953326337533055,0.4544933372541944,0.10597339937047505,0.45147970393997294,0.43796710112506215,0.11055319493496482,1,0,1,1,2,1,0
298,262,343,-36,45,0.4207418587327274,0.44578391383183,0.13347422743544265,0.41196668446977547,0.4614125504801544,0.12662076505007025,1,0,1,1,2,0,0
251,119,220,-132,-31,0.44497674406853677,0.43727565705445226,0.11774759887701096,0.460554812415028,0.42797581477036056,0.11146937281461156,1,0,1,1,2,1,0
282,200,265,-82,-17,0.5046185379764574,0.38497618019578195,0.1104052818277609,0.4447960869387069,0.44200887108444425,0.11319504197684871,1,0,1,1,2,1,0
219,183,199,-36,-20,0.37265890266213575,0.5109304827281754,0.11641061460968886,0.42745322956199716,0.46135567263566063,0.11119109780234224,1,0,1,3,2,1,0
505,183,196,-322,-309,0.32102001905984284,0.5544764560305906,0.12450352490956637,0.38425986838231374,0.5062162834244153,0.10952384819327067,1,1,2,3,4,1,0
354,258,368,-96,14,0.4498944381082023,0.44458247473078316,0.10552308716101459,0.3373218558450067,0.5523764925671198,0.11030165158787361,1,0,2,3,2,0,0
474,424,452,-50,-22,0.4215722366551198,0.471034974059067,0.10739278928581306,0.35131357000733254,0.5375788280643029,0.1111076019283646,1,0,2,2,2,1,0
475,358,392,-117,-83,0.24449500301691365,0.6031112338269466,0.15239376315613956,0.4760819211380735,0.4107221453632512,0.11319593349867535,0,0,1,5,0,1,0
285,213,254,-72,-31,0.49978410956940467,0.38047681578602843,0.11973907464456707,0.5405798443527202,0.3393266241814275,0.12009353146585233,0,1,2,1,1,1,0
356,378,527,22,171,0.4941933464292284,0.38146359844272887,0.12434305512804267,0.4554917298395455,0.426592725787784,0.11791554437267018,1,0,2,2,2,0,1
286,443,479,157,193,0.42886701101235725,0.45100103333424096,0.12013195565340173,0.4629841145085085,0.4203340129155113,0.11668187257598042,1,1,1,1,4,0,1
300,182,317,-118,17,0.46150621063683855,0.427955839825767,0.11053794953739451,0.43568803444861137,0.45465698876853744,0.10965497678285131,1,0,1,1,2,0,0
143,18,52,-125,-91,0.5395614460163584,0.3361438939396733,0.12429466004396815,0.48625925603231,0.39698992737634947,0.11675081659134053,0,1,1,1,1,1,0
262,200,214,-62,-48,0.4872120354437048,0.3995625322921399,0.11322543226415552,0.4345515470198021,0.45368505120280833,0.11176340177738962,1,0,1,1,3,1,0
333,249,294,-84,-39,0.38628292653823965,0.49614974354113384,0.1175673299206266,0.504079739846895,0.3728003746331073,0.12311988551999747,1,0,2,1,2,1,0
216,173,182,-43,-34,0.4806696654907283,0.4041191124235775,0.11521122208569422,0.47709221516560213,0.40562109669142093,0.11728668814297662,1,1,1,1,4,1,0
384,327,353,-57,-31,0.4794469923661607,0.40713231674515715,0.11342069088868222,0.4805890274523465,0.40433124520808456,0.11507972733956884,0,0,1,1,0,1,0
362,228,245,-134,-117,0.39190639606162875,0.5098808409064819,0.09821276303188918,0.47395941818604315,0.41442692191812186,0.11161365989583527,0,0,2,1,0,1,0
385,353,369,-32,-16,0.46896297187368874,0.4222914435695859,0.10874558455672531,0.4376890386387938,0.4487170012953073,0.11359396006589902,1,0,1,1,2,1,0
272,247,313,-25,41,0.419759298000742,0.47258489285515726,0.10765580914410067,0.42578702412459607,0.4617601142800752,0.112452861595329,1,0,1,1,2,0,0
292,236,254,-56,-38,0.4775269013466597,0.4116121448041147,0.11086095384922569,0.4842290506236611,0.4004143860308994,0.11535656334543963,1,1,1,1,4,1,0
348,378,400,30,52,0.35322231390969766,0.5269431460601721,0.11983454003013044,0.45848358435170805,0.42371337953786053,0.11780303611043154,0,0,4,3,0,0,1
313,249,268,-64,-45,0.3979605579636018,0.47005517389354134,0.13198426814285677,0.5295119370791117,0.35575921241809694,0.11472885050279145,0,1,2,2,1,1,0
381,265,333,-116,-48,0.3885440706448262,0.47924275543138245,0.13221317392379112,0.41668045152433936,0.47481383513460007,0.10850571334106064,1,0,1,1,3,1,0
356,329,381,-27,25,0.3711870460823549,0.5239409148077788,0.10487203910986603,0.4576817498605715,0.43057911705090923,0.11173913308851936,1,0,1,2,2,0,0
292,219,231,-73,-61,0.5034996593820573,0.38514734596637024,0.11135299465157246,0.48120116113586453,0.4063743761566302,0.11242446270750495,0,0,2,3,0,1,0
699,628,653,-71,-46,0.3638339736801643,0.5028906153971407,0.13327541092269538,0.45444536998398755,0.4012661813724228,0.14428844864358975,1,0,1,5,2,1,0
343,284,296,-59,-47,0.4019826827755778,0.4918363336577889,0.1061809835666334,0.44444302875776426,0.43004676710751366,0.12551020413472205,0,1,3,1,1,1,0
392,195,309,-197,-83,0.4432243419814469,0.43737606524032474,0.11939959277822831,0.4870792329186472,0.38437242327631327,0.12854834380503954,1,1,1,1,4,1,0
301,337,369,36,68,0.39761254157055365,0.49171349586110036,0.1106739625683458,0.45109092827325686,0.4369762234417929,0.11193284828495029,1,0,1,8,2,0,1
305,205,322,-100,17,0.4575767489176535,0.44170541512818867,0.10071783595415786,0.3874428112529328,0.501939143911977,0.11061804483509033,1,0,1,1,2,0,0
317,329,551,12,234,0.46630936755830166,0.41250716437478296,0.12118346806691536,0.3806074625721959,0.5066800478186333,0.11271248960917056,1,0,2,3,2,0,1
246,98,198,-148,-48,0.4782072669702597,0.4010138722951028,0.12077886073463745,0.4900332432349346,0.3853452032536791,0.1246215535113867,0,1,1,1,1,1,0
384,342,373,-42,-11,0.4614199255897785,0.4175085627106952,0.12107151169952629,0.4501059062917448,0.4386526401349708,0.11124145357328447,1,0,1,2,2,1,0
274,230,257,-44,-17,0.5635399025600216,0.32413645719249307,0.1123236402474853,0.4796071788852111,0.40916639751604794,0.11122642359874103,1,0,1,1,2,1,0
336,319,326,-17,-10,0.37122115265781996,0.5098194524631251,0.11895939487905481,0.4104158296831395,0.47801038795576867,0.11157378236109163,1,0,3,2,2,1,0
215,156,232,-59,17,0.4104940813951067,0.49231537939104986,0.09719053921384366,0.47517269937568773,0.40993348702821536,0.1148938135960969,1,1,1,2,4,0,0
281,167,185,-114,-96,0.3983981072061622,0.4908802369165489,0.11072165587728915,0.3772243171485226,0.5103652908045616,0.11241039204691577,0,1,2,1,1,1,0
366,418,492,52,126,0.2857938111700352,0.5877327481581767,0.12647344067178828,0.3831365802585677,0.4988477158438946,0.11801570389753774,1,1,1,1,4,0,1
283,240,259,-43,-24,0.4492180192699051,0.44179297858566674,0.10898900214442787,0.43306511069525444,0.45424124638298446,0.11269364292176096,1,1,1,2,4,1,0
576,460,478,-116,-98,0.3087355809509801,0.5215790508977884,0.1696853681512314,0.3985636843138002,0.4950735912961335,0.10636272439006605,1,0,1,3,2,1,0
352,233,276,-119,-76,0.39482977232925853,0.478994041549663,0.12617618612107823,0.53839841089088,0.3449614780745062,0.1166401110346137,0,1,1,1,1,1,0
289,112,242,-177,-47,0.5052249589111417,0.38756307854843347,0.10721196254042492,0.5057228255914742,0.38508153278091956,0.10919564162760595,0,0,1,1,0,1,0
296,242,278,-54,-18,0.4183830309483724,0.4659558533113621,0.11566111574026523,0.3854157715557737,0.5033455564651579,0.11123867197906834,1,1,2,2,4,1,0
334,301,324,-33,-10,0.39446132553286645,0.47769088455909503,0.12784778990803822,0.5261752920962296,0.36358860067964655,0.11023610722412368,0,1,3,3,1,1,0
284,220,276,-64,-8,0.45029625277534097,0.4286180917474106,0.1210856554772485,0.5119790639831545,0.3691849129597311,0.11883602305711405,1,0,1,3,2,1,0
103,0,142,-103,39,0.40696689787202006,0.4778124290763392,0.11522067305164091,0.4484018381420463,0.4396789506237969,0.1119192112341569,1,1,1,1,4,0,0
101,51,70,-50,-31,0.5046185379764574,0.38497618019578195,0.1104052818277609,0.4447960869387069,0.44200887108444425,0.11319504197684871,1,1,1,1,4,1,0
367,200,306,-167,-61,0.3316682750568437,0.5458577663798954,0.12247395856326085,0.5415236346033837,0.3431619131999843,0.11531445219663188,0,1,2,1,1,1,0
353,370,382,17,29,0.37155898310091234,0.5140470497000712,0.11439396719901654,0.4459105656520992,0.4424912440515629,0.1115981902963375,1,0,1,2,2,0,1
275,287,314,12,39,0.4575476664314266,0.43115784369327875,0.11129448987529458,0.44105231667409833,0.4463366481094747,0.11261103521642689,1,0,1,2,2,0,1
329,287,314,-42,-15,0.4575476664314266,0.43115784369327875,0.11129448987529458,0.44105231667409833,0.4463366481094747,0.11261103521642689,1,0,1,2,3,1,0
238,189,220,-49,-18,0.47395274354442773,0.39891272119064103,0.1271345352649313,0.4755174169124764,0.41372217563805025,0.11076040744947352,1,0,3,1,2,1,0
323,23,271,-300,-52,0.5046185379764574,0.38497618019578195,0.1104052818277609,0.4447960869387069,0.44200887108444425,0.11319504197684871,1,0,1,1,2,1,0
435,325,364,-110,-71,0.3761946674939415,0.4975886348783505,0.12621669762770799,0.455366928234402,0.42761940812837995,0.11701366363721809,1,0,2,1,2,1,0
320,224,293,-96,-27,0.4479668462470723,0.4253713604331646,0.12666179331976304,0.3588773066226515,0.5327329501341875,0.10838974324316104,0,0,3,1,0,1,0
416,346,409,-70,-7,0.4766115052596888,0.40760557263244335,0.11578292210786771,0.388401219622247,0.49824440765111283,0.11335437272664045,0,0,1,2,0,1,0
406,315,350,-91,-56,0.3204322595129137,0.5629067246875102,0.11666101579957616,0.458799397817431,0.4194885653745561,0.12171203680801254,1,0,1,2,3,1,0
455,361,467,-94,12,0.501936268539358,0.3628408945302628,0.13522283693037887,0.460430855559017,0.40212770565758343,0.1374414387833995,1,0,1,1,2,0,0
259,209,248,-50,-11,0.37693995059214963,0.489977086057688,0.13308296335016226,0.42887990533743187,0.45473819133116317,0.11638190333140469,1,0,1,2,3,1,0
268,229,244,-39,-24,0.40872824398567215,0.478539765233394,0.11273199078093385,0.4116889348788724,0.47556956808717543,0.11274149703395198,1,1,2,2,4,1,0
349,288,314,-61,-35,0.3940853680222718,0.4906214100366925,0.11529322194103576,0.4743600270025539,0.40817708420827564,0.11746288878917059,1,1,1,1,4,1,0
361,302,338,-59,-23,0.37586400620751864,0.4944495995187652,0.1296863942737164,0.45613214703899096,0.43453942083169533,0.10932843212931391,1,0,2,2,2,1,0
495,399,422,-96,-73,0.4770133054927229,0.4246440868462985,0.09834260766097856,0.3821998930421368,0.50814028835593,0.10965981860193298,0,0,1,2,0,1,0
299,238,252,-61,-47,0.40032725449510026,0.4980257794027165,0.1016469661021832,0.4098362857468326,0.47590204607587017,0.11426166817729717,0,0,4,1,0,1,0
251,118,239,-133,-12,0.4219410959688028,0.45163872807170136,0.12642017595949573,0.4582925655245849,0.4295589398886198,0.11214849458679502,1,0,1,1,2,1,0
401,197,345,-204,-56,0.3600875896593188,0.5177596426817032,0.1221527676589782,0.4813917856844239,0.40638618977729196,0.11222202453828414,0,0,2,1,0,1,0
332,205,308,-127,-24,0.3801815759021151,0.5014454819954253,0.11837294210245941,0.5251115688063319,0.36603118017614067,0.10885725101752745,0,0,2,1,0,1,0
399,319,377,-80,-22,0.37281158132447373,0.4922212913011945,0.13496712737433172,0.36641238368732687,0.521439888125203,0.11214772818746988,1,0,1,2,2,1,0
271,295,304,24,33,0.4775620804250884,0.4187390088044517,0.10369891077045985,0.4204793414117447,0.46879968660659294,0.11072097198166235,1,0,2,3,2,0,1
333,228,251,-105,-82,0.5139978060121181,0.3701365473808323,0.11586564660704973,0.536774578283779,0.34824971008335875,0.11497571163286228,1,0,1,1,2,1,0
255,162,245,-93,-10,0.5046185379764574,0.38497618019578195,0.1104052818277609,0.4447960869387069,0.44200887108444425,0.11319504197684871,1,0,1,2,2,1,0
348,237,319,-111,-29,0.41959114210024123,0.45702629267513634,0.12338256522462218,0.45861074272354535,0.4296964699238857,0.11169278735256877,0,0,2,1,0,1,0
952,782,891,-170,-61,0.5046185379764574,0.38497618019578195,0.1104052818277609,0.4447960869387069,0.44200887108444425,0.11319504197684871,1,0,1,1,2,1,0
418,241,280,-177,-138,0.3595921682865787,0.5009164854440267,0.13949134626939483,0.5230201382743277,0.35971783847410693,0.11726202325156536,0,0,3,1,0,1,0
407,367,397,-40,-10,0.41818898730211845,0.4521304963535994,0.12968051634428218,0.43730316445200307,0.449582951526348,0.11311388402164888,1,0,3,2,2,1,0
302,323,343,21,41,0.5150966713535359,0.37161410070237794,0.11328922794408611,0.5174320968688224,0.36735797134161347,0.11520993178956415,1,0,1,1,2,0,1
280,195,223,-85,-57,0.3538882807873596,0.5161611013464784,0.12995061786616188,0.4148160866149128,0.4557092730436087,0.1294746403414786,0,1,2,1,1,1,0
316,125,228,-191,-88,0.3775078099616166,0.496216665700765,0.12627552433761835,0.5117583553919608,0.3658506007793732,0.1223910438286659,1,1,1,1,4,1,0
477,435,455,-42,-22,0.45573384162341496,0.4406527661525746,0.10361339222401024,0.4682683442871028,0.4179988652120372,0.11373279050085983,1,0,1,1,3,1,0
181,81,87,-100,-94,0.4264380384808659,0.43817204837507967,0.13538991314405413,0.43447997972118485,0.44489846353065826,0.12062155674815693,0,1,1,1,1,1,0
249,390,434,141,185,0.442840529101199,0.4583353889406798,0.09882408195812115,0.41148444405569923,0.47783582697128385,0.11067972897301676,0,1,1,3,1,0,1
434,263,444,-171,10,0.3478406631866068,0.5417410792004096,0.11041825761298373,0.37781550001627373,0.5095155362609666,0.11266896372275965,1,0,1,1,2,0,0
271,202,254,-69,-17,0.4801749832855254,0.40679588276258044,0.11302913395189428,0.40904077270198247,0.4737911817867854,0.11716804551123211,0,0,1,2,0,1,0
312,234,278,-78,-34,0.5176593237297223,0.381398194806082,0.10094248146419553,0.47018843587804154,0.41470718545441615,0.11510437866754217,0,0,3,2,0,1,0
597,375,393,-222,-204,0.4022661806836991,0.4748929533203348,0.12284086599596612,0.5068577058185256,0.3798984878469005,0.11324380633457407,0,0,1,2,0,1,0
329,250,260,-79,-69,0.4952228180829786,0.40279232398828585,0.10198485792873545,0.42119676087565844,0.46704440761376104,0.1117588315105804,1,0,4,1,2,1,0
378,277,303,-101,-75,0.5008291421147166,0.38991680954792796,0.10925404833735533,0.39047314419142687,0.4954210486547879,0.11410580715378515,0,0,1,1,0,1,0
304,247,281,-57,-23,0.3902195902068739,0.49400787167920124,0.11577253811392489,0.4075153870737811,0.4808496873603331,0.11163492556588572,1,0,1,1,3,1,0
469,481,505,12,36,0.549711198368432,0.33470119532034837,0.11558760631121956,0.4557247350803552,0.4328366582985549,0.11143860662108951,1,0,2,1,2,0,1
293,305,347,12,54,0.4051792501460888,0.47096404524255464,0.12385670461135674,0.4719165662171413,0.41279445032031004,0.11528898346254869,1,0,1,2,2,0,1
277,341,354,64,77,0.3924785861190686,0.48562858846907614,0.12189282541185513,0.3927067982651966,0.4896534136751168,0.11763978805968671,1,1,1,2,4,0,1
314,225,251,-89,-63,0.4874823629661868,0.3972509894535769,0.1152666475802362,0.46635609860095717,0.4138085909002964,0.11983531049874648,0,1,1,3,1,1,0
362,207,236,-155,-126,0.43100537449989457,0.45870602148418815,0.11028860401591711,0.4780732402839706,0.41174796266227476,0.11017879705375448,0,0,1,1,0,1,0
393,277,323,-116,-70,0.4537493418588407,0.421483163163229,0.12476749497793034,0.5419181273301904,0.34373403548918363,0.11434783718062574,0,1,2,1,1,1,0
229,208,220,-21,-9,0.4894710723472234,0.4042423430387872,0.10628658461398933,0.44808308196149166,0.43501623752113605,0.11690068051737197,0,0,1,2,0,1,0
422,309,360,-113,-62,0.2808643043826993,0.5757354890782491,0.14340020653905103,0.45315361950609295,0.4361181354230343,0.11072824507087282,1,0,1,2,3,1,0
352,328,382,-24,30,0.44851027644095587,0.42984996438728057,0.1216397591717635,0.4117034172608455,0.4754862897036714,0.11281029303548334,1,0,1,2,2,0,0
388,338,369,-50,-19,0.4356891309371694,0.43740534379485857,0.12690552526797214,0.4049507678965024,0.4833838276416012,0.11166540446189609,1,0,1,1,2,1,0
324,202,255,-122,-69,0.4284760279404824,0.4583777665305371,0.11314620552898054,0.5021913032998416,0.3783078103757696,0.11950088632438872,0,0,1,1,0,1,0
351,249,276,-102,-75,0.4466581795741303,0.4480592292609803,0.10528259116488961,0.46829875194725545,0.41948772585045346,0.11221352220229122,1,0,1,3,3,1,0
419,350,410,-69,-9,0.44245303983049533,0.43982374351811565,0.1177232166513887,0.5037491307909503,0.37609458040079297,0.12015628880825659,1,1,2,6,4,1,0
535,492,553,-43,18,0.3798324117837223,0.48835005679511534,0.1318175314211625,0.49828677764310914,0.360351527276728,0.14136169508016308,1,0,1,1,2,0,0
409,141,167,-268,-242,0.46008765875427426,0.4300321830160092,0.1098801582297165,0.4921482713877633,0.378844629982967,0.1290070986292696,1,1,1,1,4,1,0
272,216,247,-56,-25,0.46982596733416604,0.41135553517688733,0.11881849748894688,0.48554407261607485,0.4005385989341194,0.11391732844980577,0,0,1,1,0,1,0
244,197,220,-47,-24,0.5124195633406815,0.3878939971196439,0.09968643953967489,0.42521668939059737,0.4611204237382935,0.11366288687110894,1,0,1,2,3,1,0
381,244,336,-137,-45,0.3885663924692191,0.49198670105937387,0.11944690647140661,0.44599259335447977,0.43955269887069337,0.11445470777482682,1,0,1,1,2,1,0
298,341,390,43,92,0.41673717806339355,0.45814166007176615,0.12512116186484054,0.5464697369231559,0.339415720744147,0.11411454233269701,1,0,4,1,2,0,1
253,187,217,-66,-36,0.45285935317107595,0.423287590199517,0.12385305662940688,0.5242629893171764,0.35763423592112054,0.11810277476170297,1,0,3,1,2,1,0
401,261,324,-140,-77,0.37119645738023266,0.5190544273012698,0.10974911531849754,0.36000451914318615,0.5298735968899977,0.11012188396681588,0,0,1,2,0,1,0
461,624,645,163,184,0.26314104380370945,0.6312237335287921,0.10563522266749843,0.5385269478376528,0.34247755726745266,0.11899549489489462,1,0,4,1,2,0,1
299,159,239,-140,-60,0.474186848237188,0.40359418495016547,0.12221896681264625,0.45013231807661025,0.4384496404190912,0.11141804150429822,0,0,3,2,0,1,0
396,249,276,-147,-120,0.46526239216143667,0.3764083618111649,0.15832924602739837,0.4389255870066912,0.43096035212725964,0.1301140608660492,1,0,2,2,3,1,0
379,417,475,38,96,0.5131310053520196,0.3723530698201735,0.11451592482780706,0.42600592378992896,0.46244476462004935,0.11154931159002147,1,0,2,4,3,0,1
407,211,233,-196,-174,0.5148244670889666,0.3770225687821952,0.1081529641288383,0.48299960622485305,0.3985738669297025,0.11842652684544443,0,1,1,1,1,1,0
326,139,212,-187,-114,0.38818706039617873,0.48263033599665744,0.1291826036071639,0.4384106279757753,0.44654813146873296,0.11504124055549206,1,1,2,1,4,1,0
288,255,279,-33,-9,0.3410118327569185,0.5227051070018656,0.13628306024121636,0.42377625318168183,0.4653686217516468,0.11085512506667114,0,1,1,1,1,1,0
392,260,311,-132,-81,0.33118799651703146,0.5414153635985697,0.12739663988439875,0.39684345161197776,0.491228053310692,0.11192849507733023,0,0,1,3,0,1,0
297,229,253,-68,-44,0.38871721492978567,0.4899085611684689,0.12137422390174542,0.4302173718575384,0.4572276980291515,0.11255493011331034,1,1,1,2,4,1,0
356,210,334,-146,-22,0.5046185379764574,0.38497618019578195,0.1104052818277609,0.4447960869387069,0.44200887108444425,0.11319504197684871,1,0,1,1,2,1,0
314,166,231,-148,-83,0.4977522894543701,0.39781835303758917,0.10442935750804061,0.4208330640768138,0.46787297744435663,0.1112939584788291,0,0,1,2,0,1,0
279,292,343,13,64,0.40927123277899174,0.4476186680633127,0.1431100991576954,0.487826578110858,0.3958447285255858,0.11632869336355638,1,0,1,1,2,0,1
295,99,307,-196,12,0.5675501172461548,0.3174603197876001,0.1149895629662452,0.4706723184993204,0.41891880016589067,0.11040888133478875,1,0,1,2,2,0,0
391,44,179,-347,-212,0.37208978707131085,0.5202351047802883,0.10767510814840085,0.45691669512309074,0.43547013595811374,0.10761316891879542,0,0,2,1,0,1,0
338,280,294,-58,-44,0.5077970569633453,0.38930935735992417,0.10289358567673028,0.34281043703373054,0.5492845246537482,0.10790503831252093,0,0,1,2,0,1,0
195,20,233,-175,38,0.41005456353984593,0.4724110102860691,0.11753442617408516,0.3493572038156656,0.5388768392713409,0.11176595691299344,1,1,1,1,4,0,0
499,406,454,-93,-45,0.47652923608935227,0.39827448314024966,0.12519628077039774,0.4753559981398125,0.4100489847903391,0.11459501706984855,1,0,4,1,2,1,0
326,218,288,-108,-38,0.497335316465863,0.3824194329573786,0.12024525057675847,0.41182002100265025,0.4749912821899063,0.1131886968074432,0,0,1,1,0,1,0
215,234,264,19,49,0.5076253034548579,0.3959556584697785,0.09641903807536363,0.3998434389413761,0.4903440772367849,0.1098124838218391,1,0,1,1,2,0,1
369,269,343,-100,-26,0.3126811994433264,0.5672012920621231,0.12011750849455047,0.3978113302874409,0.4911415185654638,0.11104715114709497,1,0,1,1,2,1,0
272,244,261,-28,-11,0.4077913073727439,0.4885895012516243,0.10361919137563157,0.4620037799435088,0.4252991208566255,0.11269709919986567,1,0,2,3,2,1,0
391,351,377,-40,-14,0.5127836177287036,0.3708257984312176,0.11639058384007872,0.47269203171803065,0.4168103225154847,0.11049764576648453,0,0,1,1,0,1,0
374,183,261,-191,-113,0.4408139232052054,0.45387685602532307,0.1053092207694713,0.41416210553813915,0.47470457243524694,0.11113332202661377,1,1,1,3,4,1,0
306,62,93,-244,-213,0.32508280556851676,0.5366702981592694,0.13824689627221404,0.4532034906988038,0.4358940346681279,0.1109024746330683,1,1,1,1,4,1,0
377,293,469,-84,92,0.3589834255698815,0.5050725228986882,0.13594405153143052,0.4056475636255884,0.48427470693391833,0.11007772944049325,0,0,1,2,0,0,0
290,238,320,-52,30,0.3715921417215687,0.49597883276757515,0.13242902551085622,0.3370996559974515,0.5519153052670464,0.11098503873550196,1,0,1,1,2,0,0
229,154,173,-75,-56,0.4169007124980836,0.4468058324946522,0.13629345500726409,0.4377168846894419,0.4521277639488132,0.11015535136174487,1,0,2,3,3,1,0
417,224,251,-193,-166,0.41682135770681045,0.4485731790811576,0.1346054632120321,0.5039141264209395,0.3826100491660702,0.11347582441299052,0,0,2,1,0,1,0
306,199,226,-107,-80,0.45522816310606795,0.4308935095926701,0.11387832730126228,0.4756937635358234,0.4077068841235645,0.11659935234061207,1,0,2,2,2,1,0
363,166,312,-197,-51,0.44745841067688064,0.4373235296889939,0.11521805963412568,0.5710079709447858,0.31565549759193323,0.11333653146328128,0,0,1,1,0,1,0
293,305,321,12,28,0.4474876264999577,0.4468339803957163,0.10567839310432582,0.4414165909848906,0.4348787769278419,0.1237046320872673,1,0,1,1,2,0,1
243,23,139,-220,-104,0.41819728478143536,0.4647149795292848,0.11708773568927933,0.4426536966028432,0.44615041608537875,0.11119588731177779,1,0,1,1,3,1,0
287,184,338,-103,51,0.28172534723681686,0.6248508037697799,0.09342384899340311,0.5411521653576113,0.34114342915764595,0.11770440548474279,0,0,2,1,0,0,0
259,206,248,-53,-11,0.43609374368792075,0.4466782413480363,0.11722801496404286,0.42196698994188025,0.46749245607358386,0.1105405539845356,1,1,1,2,4,1,0
231,152,218,-79,-13,0.5312916798163311,0.3559961169584064,0.11271220322526258,0.4917783825650509,0.3869102578476579,0.12131135958729104,0,1,1,1,1,1,0
299,203,218,-96,-81,0.40868233946310034,0.4823364291732911,0.10898123136360839,0.3241687178571451,0.5666974018893576,0.1091338802534972,0,0,2,3,0,1,0
473,379,459,-94,-14,0.24014702882549238,0.6110595430666765,0.14879342810783105,0.34295051855063036,0.5450485556410102,0.11200092580835944,1,0,1,2,2,1,0
268,279,336,11,68,0.5046185379764574,0.38497618019578195,0.1104052818277609,0.4447960869387069,0.44200887108444425,0.11319504197684871,1,1,1,4,4,0,1
321,257,290,-64,-31,0.44483237914868107,0.4351864778685375,0.11998114298278116,0.4117186738928052,0.4768891070055456,0.1113922191016493,1,0,2,1,2,1,0
297,384,414,87,117,0.4627125637329445,0.42773698788972886,0.1095504483773264,0.500165429747142,0.3768487934780346,0.1229857767748233,0,0,1,1,0,0,1
424,267,465,-157,41,0.43545092106499983,0.44096334191708836,0.1235857370179117,0.44540284680847936,0.44425107700231575,0.11034607618920508,1,0,1,1,2,0,0
412,281,335,-131,-77,0.3029508517594931,0.5844140061199612,0.11263514212054583,0.45966558630839804,0.41436398160943494,0.12597043208216702,0,0,3,1,0,1,0
306,175,275,-131,-31,0.46248620194530415,0.43334405043256585,0.10416974762212992,0.39380844391055014,0.49626410888493633,0.10992744720451372,1,1,1,3,4,1,0
329,376,467,47,138,0.4861087746552432,0.40657697907852275,0.10731424626623404,0.5096431616000292,0.37892719486279736,0.11142964353717372,0,1,1,6,1,0,1
174,185,218,11,44,0.4622452774451906,0.43558301318864473,0.10217170936616472,0.43759928597278125,0.4513144215567431,0.11108629247047548,1,1,3,2,4,0,1
444,274,384,-170,-60,0.46813183218650883,0.4233900292034885,0.10847813861000269,0.5144072363761435,0.3714802217871926,0.11411254183666375,1,0,1,1,3,1,0
303,283,318,-20,15,0.4768179432018267,0.4020567646408475,0.12112529215732575,0.4191382023971537,0.46956832216561833,0.111293475437228,1,1,1,1,4,0,0
376,337,348,-39,-28,0.3792636530845067,0.5111852704180495,0.10955107649744364,0.4106394022616083,0.4800359922437963,0.10932460549459551,0,1,2,3,1,1,0
272,215,258,-57,-14,0.486556555982577,0.3905869887581302,0.12285645525929298,0.46044338510172816,0.4271054109085947,0.11245120398967708,1,1,2,1,4,1,0
312,222,245,-90,-67,0.4085656988666539,0.47614185049182334,0.1152924506415227,0.3421252908545002,0.5463060178430162,0.11156869130248372,0,0,1,3,0,1,0
328,302,355,-26,27,0.32396893940442845,0.5521318891249668,0.12389917147060503,0.41318861238368326,0.47419192824137385,0.11261945937494308,1,0,1,3,2,0,0
352,371,465,19,113,0.5072346708737304,0.35657513777315947,0.13619019135311017,0.5391302383865098,0.34367458675619517,0.11719517485729536,0,0,1,1,0,0,1
302,223,248,-79,-54,0.5350670758017548,0.35621525975530627,0.10871766444293883,0.43848817282290387,0.4512029996757105,0.11030882750138565,0,0,1,1,0,1,0
331,270,306,-61,-25,0.4490336035930856,0.43089586571342453,0.12007053069349025,0.45879180902175987,0.4232246855697751,0.11798350540846503,1,1,1,1,4,1,0
149,0,130,-149,-19,0.4320037273042509,0.46108953839978056,0.10690673429596856,0.46424384680334735,0.4175622462293498,0.11819390696730273,0,0,1,1,0,1,0
291,115,199,-176,-92,0.5202105153577741,0.3643010018243933,0.11548848281783262,0.4578701084097038,0.42946646737929156,0.11266342421100473,1,0,1,1,3,1,0
427,239,308,-188,-119,0.4446626167275008,0.4425909966017521,0.11274638667074724,0.5411462671426068,0.33529102166526764,0.12356271119212557,0,1,2,1,1,1,0
67,169,329,102,262,0.5046185379764574,0.38497618019578195,0.1104052818277609,0.4447960869387069,0.44200887108444425,0.11319504197684871,1,1,1,1,4,0,1
424,386,441,-38,17,0.39622662249380863,0.46050395060489235,0.1432694269012989,0.35291796091881455,0.5371290280704011,0.10995301101078439,1,0,2,2,2,0,0
136,151,170,15,34,0.4400229283792009,0.44356643415936986,0.11641063746142911,0.41450544890270535,0.47410169290024695,0.1113928581970477,1,1,2,1,4,0,1
257,208,279,-49,22,0.2703231143496992,0.6218876053614785,0.1077892802888224,0.40167874093176037,0.4867468307176338,0.11157442835060599,1,0,1,2,2,0,0
115,128,158,13,43,0.4722464582718555,0.3988507816775865,0.1289027600505581,0.44951143551472156,0.43857248703303686,0.11191607745224177,1,0,4,1,2,0,1
304,145,246,-159,-58,0.5164797699440529,0.3745328226521149,0.10898740740383239,0.4813113895775347,0.4058680421662116,0.1128205682562536,1,1,1,1,4,1,0
309,245,276,-64,-33,0.47624832638093373,0.4088241464594072,0.11492752715965905,0.492891571124214,0.39057208726566767,0.11653634161011853,1,0,4,1,3,1,0
334,293,312,-41,-22,0.43092602912006306,0.4554184339371753,0.1136555369427617,0.4599062080200253,0.4292142315139824,0.11087956046599239,1,1,2,4,4,1,0
295,245,277,-50,-18,0.37776768786281967,0.48255174019731817,0.13968057193986216,0.4524311905191929,0.4199629722670738,0.1276058372137335,1,0,1,1,2,1,0
390,296,359,-94,-31,0.37018151940003613,0.5134385028925352,0.11637997770742832,0.4455238087713428,0.4428284712880041,0.11164771994065315,1,0,1,2,2,1,0
386,295,322,-91,-64,0.371890048548265,0.4999453118728862,0.1281646395788486,0.5156742977347268,0.37808830260888554,0.10623739965638748,0,0,1,1,0,1,0
258,196,210,-62,-48,0.38792138600382303,0.4964328399801765,0.11564577401600039,0.4582439939974187,0.42885709286116525,0.11289891314141601,0,1,1,1,1,1,0
222,25,192,-197,-30,0.42835225091211454,0.45572132710414254,0.11592642198374271,0.43234137945864276,0.4556406531739184,0.11201796736743902,1,0,1,1,2,1,0
260,184,245,-76,-15,0.38806681902631485,0.4761096703038419,0.13582351066984302,0.45809482194010853,0.42926495699220524,0.11264022106768617,1,1,3,1,4,1,0
302,272,290,-30,-12,0.39628188123602154,0.4937765212647426,0.1099415974992356,0.45075334096628655,0.43653450160895513,0.11271215742475857,1,1,3,3,4,1,0
265,160,239,-105,-26,0.5368304922876206,0.35768916185546484,0.10548034585691456,0.48996250446708256,0.3940995340152885,0.11593796151762908,0,0,1,1,0,1,0
128,170,197,42,69,0.4578336603608108,0.42513462527035883,0.11703171436883054,0.4184501314199964,0.47065057881684014,0.11089928976316353,0,0,1,1,0,0,1
414,342,401,-72,-13,0.46017310858088356,0.4070435848817862,0.13278330653733011,0.4037713552847181,0.48835501386083163,0.10787363085445023,1,0,2,1,2,1,0
262,187,194,-75,-68,0.4792267717089294,0.4024362273289395,0.11833700096213079,0.40059676535559213,0.48927273443343783,0.1101305002109701,1,1,1,4,4,1,0
410,307,476,-103,66,0.42783040817236245,0.45187397516220873,0.12029561666542893,0.46442967595421264,0.42066627375273,0.1149040502930574,0,0,1,1,0,0,0
308,210,288,-98,-20,0.5046185379764574,0.38497618019578195,0.1104052818277609,0.4447960869387069,0.44200887108444425,0.11319504197684871,1,0,1,1,2,1,0
356,305,344,-51,-12,0.4647707976180575,0.3992506308023512,0.13597857157959126,0.5416708070759603,0.3399468397190002,0.11838235320503955,0,1,2,1,1,1,0
316,296,338,-20,22,0.37761036216049987,0.4887370847143794,0.13365255312512062,0.4117788693120232,0.47958935570791755,0.10863177498005923,1,0,2,1,2,0,0
383,316,330,-67,-53,0.4385570707689551,0.45993261280267056,0.10151031642837428,0.43768878499483416,0.44853489620062525,0.11377631880454066,1,0,1,2,2,1,0
337,302,326,-35,-11,0.39446749644926843,0.46163920050292717,0.14389330304780468,0.4927227893798572,0.3761133333436792,0.1311638772764635,1,0,1,1,2,1,0
299,61,123,-238,-176,0.4976200931276379,0.3943113247276996,0.10806858214466257,0.4047470076363886,0.48276197217760486,0.11249102018600625,1,0,1,1,2,1,0
258,152,218,-106,-40,0.44739321605437593,0.4333791706205147,0.11922761332510926,0.42794455865219,0.4594733058769994,0.11258213547081061,0,1,1,1,1,1,0
473,357,421,-116,-52,0.4926123728156116,0.3932442257331167,0.1141434014512715,0.5191800470674248,0.36372047319212825,0.11709947974044674,0,0,1,1,0,1,0
373,212,340,-161,-33,0.5214202293730961,0.37155409049828014,0.10702568012862367,0.4527885088778872,0.43619529078846103,0.11101620033365142,1,1,2,1,4,1,0
328,309,316,-19,-12,0.4631414711430652,0.41203382631656105,0.12482470254037369,0.3819929483766295,0.5091034515111847,0.1089036001121857,0,1,3,3,1,1,0
378,338,348,-40,-30,0.40468834044705293,0.46456509651871797,0.1307465630342291,0.5441727497551426,0.3396771032450668,0.11615014699979065,1,1,2,1,4,1,0
524,425,483,-99,-41,0.44186985326916334,0.42973294099304904,0.12839720573778776,0.43378033090298723,0.42458474238192817,0.1416349267150846,1,0,1,1,2,1,0
384,275,309,-109,-75,0.34762564995051315,0.5380569646820074,0.11431738536747942,0.4393785634428188,0.44775137949773,0.11287005705945131,0,0,1,1,0,1,0
259,226,270,-33,11,0.47946933554045185,0.4159133117244638,0.10461735273508405,0.39554368598176187,0.4944968199557138,0.10995949406252449,1,0,1,3,2,0,0
300,267,281,-33,-19,0.4498745880342245,0.440993271867924,0.10913214009785148,0.4338125205998288,0.4550435551441068,0.11114392425606456,1,0,2,2,2,1,0
435,310,359,-125,-76,0.26781718999838755,0.5976917617145447,0.13449104828706782,0.4738790384574655,0.4070925494936851,0.11902841204884945,0,1,2,1,1,1,0
297,82,200,-215,-97,0.5046185379764574,0.38497618019578195,0.1104052818277609,0.4447960869387069,0.44200887108444425,0.11319504197684871,1,1,2,1,4,1,0
322,191,307,-131,-15,0.43985993150310065,0.4488649682131783,0.11127510028372098,0.5384362416563109,0.34742143449604596,0.11414232384764296,0,0,2,1,0,1,0
560,247,286,-313,-274,0.5046185379764574,0.38497618019578195,0.1104052818277609,0.4447960869387069,0.44200887108444425,0.11319504197684871,1,1,1,1,4,1,0
254,192,235,-62,-19,0.5095080373314649,0.3863092561791811,0.10418270648935396,0.4053362455432322,0.47950358672706245,0.11516016772970494,0,0,1,1,0,1,0
419,380,400,-39,-19,0.3951342715539685,0.48153914198956316,0.12332658645646828,0.4385711962060051,0.45124639429792535,0.11018240949606958,1,0,1,1,2,1,0
392,335,359,-57,-33,0.4529263947295836,0.4280240376240283,0.1190495676463878,0.41670193238736586,0.47046910771592465,0.1128289598967094,1,0,1,2,2,1,0
385,267,299,-118,-86,0.42761799256176974,0.46508451777103355,0.10729748966719709,0.4119512604110861,0.4765399744094204,0.11150876517949365,1,0,1,1,3,1,0
285,145,254,-140,-31,0.4302205380322556,0.45580160293680366,0.11397785903094106,0.43402498319217925,0.45394709897188323,0.11202791783593742,1,0,2,1,2,1,0
339,192,306,-147,-33,0.42073291984414724,0.4595288285735951,0.1197382515822572,0.4384422680601027,0.4487119200109846,0.11284581192891247,1,1,2,1,4,1,0
427,395,404,-32,-23,0.41439289922411454,0.4678368289029843,0.11777027187290134,0.3651174147778502,0.5248083995547581,0.11007418566739177,1,0,4,2,2,1,0
86,118,142,32,56,0.5046185379764574,0.38497618019578195,0.1104052818277609,0.4447960869387069,0.44200887108444425,0.11319504197684871,1,1,1,1,4,0,1
348,275,359,-73,11,0.4270036536222568,0.4666961106741375,0.10630023570360556,0.4736240124111389,0.4156435476741066,0.11073243991475433,1,0,1,3,2,0,0
300,237,268,-63,-32,0.3258248416291556,0.5550965929679528,0.11907856540289155,0.5001787058080821,0.38651981592412915,0.11330147826778857,0,1,1,5,1,1,0
228,201,223,-27,-5,0.5010466420983742,0.38161751020101625,0.1173358477006097,0.48280315012290215,0.4025925591765037,0.1146042907005942,1,0,2,2,2,1,0
83,0,40,-83,-43,0.483421228458249,0.4014799118693364,0.11509885967241432,0.4625415491889178,0.4244412270944253,0.11301722371665693,0,1,1,1,1,1,0
397,410,513,13,116,0.37503140417418995,0.5004948286587422,0.12447376716706776,0.4571743462706889,0.4146680732730413,0.12815758045626977,1,0,1,1,2,0,1
415,329,390,-86,-25,0.38527095701994274,0.5077290187085974,0.10700002427146005,0.467874148822265,0.4206863862875755,0.11143946489015928,0,1,1,1,1,1,0
312,202,236,-110,-76,0.34164901852231544,0.5537275282815138,0.10462345319617039,0.38045084923506517,0.5078663832055185,0.1116827675594164,1,0,3,2,3,1,0
575,431,554,-144,-21,0.41786471607043596,0.4842424728537265,0.09789281107583758,0.5420287715935526,0.34177145132213665,0.11619977708431066,1,1,1,2,4,1,0
431,382,396,-49,-35,0.468606089929643,0.41255175918223774,0.11884215088811942,0.4244229074611715,0.4669350817693766,0.10864201076945192,1,0,1,3,2,1,0
328,273,317,-55,-11,0.4660577702542564,0.4173025855056872,0.11663964424005618,0.4578292796224548,0.43153948364229106,0.11063123673525435,1,1,3,1,4,1,0
169,0,156,-169,-13,0.36109251622190464,0.5237196340364864,0.11518784974160909,0.4871566950389223,0.39377061005827446,0.11907269490280335,0,1,1,1,1,1,0
391,269,324,-122,-67,0.512210571735134,0.3700688061669532,0.11772062209791286,0.45665522988627527,0.43237420844264474,0.1109705616710798,1,1,2,1,4,1,0
491,309,472,-182,-19,0.392842138646521,0.4649567788361272,0.14220108251735214,0.4024198893796863,0.4844592868912833,0.11312082372903028,0,0,1,1,0,1,0
298,343,396,45,98,0.49980700709670073,0.3831595053555041,0.11703348754779527,0.43053598583090297,0.4583619119630204,0.11110210220607647,1,0,1,1,2,0,1
539,484,614,-55,75,0.3399196833956198,0.5104715026419727,0.14960881396240727,0.4503976606990181,0.4370333078306365,0.11256903147034536,0,0,1,3,0,0,0
292,107,225,-185,-67,0.35894218927988814,0.522948845269952,0.11810896545015973,0.5387113434078568,0.34559929316860866,0.11568936342353459,1,0,2,1,2,1,0
326,278,309,-48,-17,0.39526672349630854,0.4961598420067596,0.10857343449693191,0.4478876094734364,0.4406306075814436,0.11148178294512005,0,0,1,2,0,1,0
255,209,272,-46,17,0.29004060023981704,0.5788852093017534,0.13107419045842966,0.3837185463580261,0.509789602315861,0.10649185132611298,1,1,1,2,4,0,0
540,523,596,-17,56,0.3460305493734907,0.5420151621386595,0.11195428848784973,0.41035245756128447,0.4772677867759882,0.11237975566272733,1,0,1,1,2,0,0
322,282,299,-40,-23,0.4085491099370422,0.470197810748421,0.12125307931453681,0.40365117833703046,0.4863010345104586,0.11004778715251108,0,1,1,3,1,1,0
283,75,86,-208,-197,0.4073246748867804,0.4842268890208754,0.10844843609234416,0.43778728154667773,0.4450699840281903,0.11714273442513164,0,0,1,1,0,1,0
331,240,295,-91,-36,0.5135645469614959,0.36991444282566943,0.11652101021283472,0.4888277762190842,0.39616177171657246,0.11501045206434327,1,0,2,2,3,1,0
311,198,282,-113,-29,0.36485971749317686,0.5176943644322289,0.11744591807459401,0.4496360729408137,0.44024401521321554,0.11011991184597071,1,1,1,3,4,1,0
239,244,284,5,45,0.37516836086774047,0.5104583521546497,0.1143732869776096,0.3791410405288756,0.5100108026592278,0.11084815681189648,1,0,3,3,3,0,1
369,351,391,-18,22,0.4720329545906174,0.41550940342933385,0.1124576419800489,0.3505859601712612,0.5350283794418649,0.11438566038687382,1,0,1,1,2,0,0
316,252,271,-64,-45,0.41126004228390606,0.4481668149440368,0.14057314277205726,0.3915901676354995,0.4966690317597289,0.11174080060477147,0,0,1,1,0,1,0
91,0,144,-91,53,0.47387789060351726,0.40585621323633114,0.12026589616015164,0.4515355019097446,0.4350627887972509,0.11340170929300439,1,0,1,1,2,0,0
263,179,241,-84,-22,0.5447212321314473,0.36235437080527505,0.09292439706327757,0.5611933018871091,0.32214448812393565,0.1166622099889554,0,0,1,1,0,1,0
384,205,343,-179,-41,0.4660737721310025,0.41818780649311804,0.11573842137587935,0.46165196495001903,0.4261772155178396,0.11217081953214127,1,1,3,1,4,1,0
350,264,291,-86,-59,0.2424941011331156,0.6090961144267006,0.1484097844401838,0.38200880966352424,0.5070475449342241,0.1109436454022517,1,0,2,1,3,1,0
251,188,220,-63,-31,0.41591182965120777,0.4754717357355025,0.10861643461328982,0.5314079898301953,0.3573100339235548,0.11128197624624965,0,0,1,1,0,1,0
323,247,278,-76,-45,0.3966711438353722,0.49097643954859826,0.11235241661602921,0.35861101315614574,0.5308494067528273,0.11053958009102711,1,0,2,1,2,1,0
306,233,291,-73,-15,0.4431818460444339,0.446168635536201,0.11064951841936525,0.47014108341163763,0.4172738796752067,0.11258503691315584,0,1,1,1,1,1,0
271,103,262,-168,-9,0.4605614695744684,0.4209704927783533,0.11846803764717855,0.4546649491879685,0.4327488655413466,0.11258618527068477,0,0,1,2,0,1,0
259,195,205,-64,-54,0.23604739665941077,0.612858550657586,0.15109405268300327,0.4168009234159284,0.4619787488294298,0.12122032775464206,0,1,1,1,1,1,0
426,401,411,-25,-15,0.34226775290008293,0.49651055330102567,0.1612216937988912,0.45666880330804266,0.4201681208122514,0.12316307587970593,1,1,1,1,4,1,0
273,290,313,17,40,0.3486832450457707,0.5040731441972838,0.1472436107569457,0.40603675223212204,0.4852099096632593,0.10875333810461882,0,0,4,2,0,0,1
324,261,298,-63,-26,0.4239045539919697,0.4646246536351449,0.11147079237288537,0.46639194852928056,0.40496753515163064,0.12864051631908865,0,1,1,1,1,1,0
393,316,331,-77,-62,0.34891221991645655,0.5364191578263279,0.11466862225721552,0.4003886709840954,0.48708976683093863,0.11252156218496608,1,0,1,4,2,1,0
292,232,247,-60,-45,0.492222833049281,0.41233543528356237,0.09544173166715648,0.4509131944879218,0.4375554938001749,0.11153131171190327,0,0,1,1,0,1,0
193,226,245,33,52,0.4464902022011832,0.43662429448370166,0.11688550331511503,0.4273240437658906,0.46157797917086385,0.11109797706324531,1,1,1,3,4,0,1
384,340,372,-44,-12,0.5842310478181574,0.32192725484111756,0.09384169734072488,0.5353757835499589,0.3490742942797314,0.11554992217030954,1,1,2,3,4,1,0
268,284,299,16,31,0.3500483111704799,0.5289926500896153,0.12095903873990431,0.4625638771546729,0.4225941860720365,0.11484193677329056,1,0,1,1,3,0,1
386,225,406,-161,20,0.28442937650389954,0.6036473883635965,0.11192323513250374,0.3994291594685764,0.47245214519982615,0.12811869533159773,1,0,1,1,2,0,0
297,215,234,-82,-63,0.38566468659040987,0.48669230786045703,0.1276430055491329,0.3752008665089384,0.5146512321981148,0.11014790129294713,1,0,3,1,2,1,0
108,0,126,-108,18,0.4589762683475745,0.42859934410105094,0.1124243875513746,0.5067218005649512,0.37861015275424476,0.11466804668080406,1,0,1,3,2,0,0
471,441,450,-30,-21,0.3985528281260209,0.48927827771699456,0.11216889415698457,0.5302346170706211,0.3486985913236085,0.12106679160577043,1,0,5,2,3,1,0
359,210,326,-149,-33,0.3564581781728355,0.5220002064384472,0.12154161538871715,0.404849815864775,0.4832552201496719,0.11189496398555326,0,0,1,2,0,1,0
424,441,446,17,22,0.23961683772711467,0.6475724609363012,0.11281070133658402,0.3858938300558366,0.5037232373714136,0.11038293257274992,1,1,1,1,4,0,1
314,235,274,-79,-40,0.3600682393296585,0.5302388872108905,0.10969287345945104,0.4818959610752116,0.40557885597872456,0.11252518294606385,0,0,2,1,0,1,0
521,408,423,-113,-98,0.3975121861559606,0.48991561675283835,0.11257219709120067,0.4611787381621855,0.42481979963313754,0.11400146220467691,1,1,3,1,4,1,0
230,174,202,-56,-28,0.469478489442596,0.4054055787486249,0.1251159318087792,0.4430585515738814,0.43618945895805605,0.1207519894680625,1,0,1,1,3,1,0
433,258,345,-175,-88,0.46943930317585253,0.4215196691247626,0.10904102769938522,0.3930094212086587,0.49667898351817436,0.110311595273167,1,1,1,3,4,1,0
253,137,176,-116,-77,0.4114298001149143,0.48387984720695043,0.10469035267813527,0.4897353209558758,0.39646888433516153,0.113795794708963,0,1,1,1,1,1,0
215,161,195,-54,-20,0.4867127084474719,0.3944955632960545,0.11879172825647356,0.4735040143578839,0.4152344296951678,0.11126155594694842,1,0,3,2,3,1,0
339,195,286,-144,-53,0.5511288920048681,0.3479485267394979,0.10092258125563394,0.43870762922627976,0.44735546121479375,0.11393690955892624,1,0,1,1,2,1,0
247,188,221,-59,-26,0.46345645447812567,0.4184840735415524,0.1180594719803221,0.4986925965782579,0.3900946968488423,0.11121270657290006,0,0,1,1,0,1,0
287,167,247,-120,-40,0.44125785663765205,0.43940835497102515,0.11933378839132289,0.4739218645043841,0.4072090930705849,0.1188690424250309,1,0,2,2,2,1,0
366,278,353,-88,-13,0.32895291461600856,0.55079269144084,0.1202543939431512,0.42412972336995286,0.46319272954361135,0.11267754708643554,1,1,1,1,4,1,0
714,808,916,94,202,0.31958592999127167,0.5625120563545859,0.11790201365414238,0.5496469638422609,0.33431444641652636,0.11603858974121269,1,1,3,1,4,0,1
317,254,288,-63,-29,0.46314042483873663,0.4206182289410535,0.1162413462202097,0.4670985618643875,0.41984957051099187,0.11305186762462058,1,0,1,1,3,1,0
332,242,267,-90,-65,0.46441682190569183,0.37428263434467,0.16130054374963795,0.469507911184576,0.4189869743371942,0.11150511447822978,0,1,1,1,1,1,0
321,268,286,-53,-35,0.4411154229733246,0.46585398936207084,0.09303058766460462,0.5287239466995417,0.35609687899788983,0.11517917430256816,1,0,2,4,2,1,0
276,33,107,-243,-169,0.41583026849964316,0.4676729566522183,0.11649677484813863,0.47972106741133996,0.3963076887271183,0.1239712438615415,1,1,1,1,4,1,0
314,212,258,-102,-56,0.3553581139338134,0.5239092185576505,0.12073266750853624,0.3932234690897017,0.49695233472949035,0.10982419618080808,1,0,1,2,3,1,0
362,268,345,-94,-17,0.3999315414240869,0.4777715977172723,0.12229686085864042,0.4475257128830945,0.4349761052780167,0.11749818183888862,1,0,1,1,2,1,0
283,324,390,41,107,0.4447871165281612,0.4401032095382107,0.1151096739336283,0.4188914227499325,0.46976041211566294,0.11134816513440446,1,1,4,3,4,0,1
272,0,163,-272,-109,0.5046185379764574,0.38497618019578195,0.1104052818277609,0.4447960869387069,0.44200887108444425,0.11319504197684871,1,1,1,1,4,1,0
169,0,156,-169,-13,0.4486705256158006,0.43678517252426785,0.1145443018599316,0.4885016690035348,0.39840664065609876,0.11309169034036635,0,0,1,1,0,1,0
389,265,350,-124,-39,0.49856548437158027,0.38333660999202185,0.11809790563639799,0.5147703185764696,0.3752037279727193,0.11002595345081137,0,0,1,1,0,1,0
308,13,86,-295,-222,0.4779133903644828,0.4088143055688488,0.1132723040666683,0.471823144885902,0.4144737275096086,0.1137031276044894,0,1,1,1,1,1,0
283,159,225,-124,-58,0.5332296474489724,0.36754145563735013,0.09922889691367721,0.4417713062418328,0.44842035658526586,0.10980833717290135,1,1,2,3,4,1,0
304,326,346,22,42,0.5386929006400609,0.36553616400038014,0.09577093535955866,0.4637099862805315,0.4224994075571522,0.11379060616231633,0,1,3,3,1,0,1
216,157,191,-59,-25,0.4815935306616125,0.38024081253692954,0.13816565680145831,0.4459249615756246,0.4392979742408346,0.11477706418354054,1,1,1,1,4,1,0
233,259,328,26,95,0.45593080490556703,0.43992106767919137,0.10414812741524157,0.4510785776760549,0.4371373565202678,0.11178406580367721,0,1,2,1,1,0,1
374,294,316,-80,-58,0.3633156506402641,0.5119528393454359,0.12473151001429986,0.5162616197344023,0.36902177379249956,0.11471660647309787,0,0,1,1,0,1,0
338,272,311,-66,-27,0.49805514081358476,0.3819289346331798,0.12001592455323513,0.5181033438312904,0.36334504171585047,0.11855161445285943,1,1,1,2,4,1,0
318,367,414,49,96,0.47830628263995345,0.40407764672737206,0.11761607063267457,0.4878418853257982,0.3997081221625458,0.11244999251165606,1,0,1,4,2,0,1
382,337,352,-45,-30,0.40652268372221817,0.45606731556351354,0.1374100007142682,0.4147086493214654,0.4762835991227337,0.10900775155580097,0,0,2,1,0,1,0
446,284,377,-162,-69,0.3635329928387492,0.5145482197964879,0.12191878736476301,0.4367105936566175,0.45208391134367826,0.1112054949997041,0,0,1,3,0,1,0
271,234,259,-37,-12,0.36699070269139267,0.5058954744156746,0.12711382289293255,0.4314611947732252,0.45577716842660976,0.11276163680016486,1,1,3,3,4,1,0
136,88,122,-48,-14,0.4554793120367093,0.4407066868538454,0.1038140011094452,0.44225356874150995,0.4460561354085188,0.11169029584997144,1,1,1,1,4,1,0
298,232,315,-66,17,0.46044735042124124,0.4320952448458809,0.10745740473287764,0.44144363082197496,0.4461315118438919,0.11242485733413304,1,1,1,2,4,0,0
483,292,369,-191,-114,0.3352710112137786,0.4785068064167359,0.18622218236948532,0.541949192879333,0.33896057707486754,0.11909023004579952,0,0,2,1,0,1,0
265,57,287,-208,22,0.3579856769928496,0.517303249560782,0.12471107344636838,0.4135146453820668,0.47677352446816573,0.10971183014976754,1,0,1,1,2,0,0
291,226,323,-65,32,0.3604074771176921,0.4980693641255675,0.14152315875674013,0.47730733867073805,0.4048895355069958,0.11780312582226621,0,0,2,1,0,0,0
344,200,250,-144,-94,0.4633091200818437,0.42952716540199704,0.10716371451615939,0.44106896650303107,0.447210844922085,0.11172018857488401,0,0,1,2,0,1,0
276,227,371,-49,95,0.34674192652324787,0.5023505318832113,0.15090754159354075,0.3901632298151396,0.4928014010271073,0.11703536915775327,0,0,1,1,0,0,0
282,206,218,-76,-64,0.4524902907766302,0.4202163578735492,0.1272933513498206,0.43396514739003217,0.4446528604450877,0.12138199216488027,1,0,2,1,3,1,0
279,217,268,-62,-11,0.4721708989457645,0.3897521543340736,0.13807694672016155,0.41968390679762985,0.4672102668585366,0.11310582634383333,1,0,3,2,2,1,0
346,277,317,-69,-29,0.520374758674146,0.3649626837141739,0.11466255761168002,0.45189247015713313,0.4351992996330872,0.11290823020977973,1,0,1,1,2,1,0
307,263,289,-44,-18,0.40791432438102865,0.48067153802392454,0.11141413759504705,0.3870487459595843,0.5027204047095981,0.11023084933081756,1,1,1,1,4,1,0
269,113,160,-156,-109,0.4887830702335942,0.38893683931409867,0.1222800904523071,0.49088670488685665,0.3855228998895068,0.12359039522363659,0,0,1,1,0,1,0
15,26,74,11,59,0.5046185379764574,0.38497618019578195,0.1104052818277609,0.4447960869387069,0.44200887108444425,0.11319504197684871,1,1,2,1,4,0,1
311,363,410,52,99,0.41139516619355687,0.4371489701880165,0.15145586361842678,0.49562521485030075,0.3870899114724878,0.11728487367721105,1,0,1,3,2,0,1
283,208,254,-75,-29,0.38103884029028195,0.4915882650066692,0.12737289470304886,0.44763030268952636,0.4370478038786885,0.11532189343178507,0,0,1,1,0,1,0
442,251,410,-191,-32,0.3443116757657467,0.5222317481033212,0.13345657613093215,0.39358316672911964,0.49717214084937833,0.10924469242150223,1,1,1,1,4,1,0
254,157,224,-97,-30,0.3501642463252177,0.5236250103031151,0.12621074337166693,0.42292065732851486,0.46471867545011897,0.11236066722136621,1,0,1,2,2,1,0
322,246,302,-76,-20,0.4520253026501503,0.43487278209932567,0.11310191525052382,0.3978426964922481,0.49112162270863013,0.11103568079912206,1,1,2,3,4,1,0
260,212,245,-48,-15,0.446724321294122,0.4279778917707617,0.12529778693511628,0.4460298621577009,0.4449862094231895,0.10898392841910964,0,1,2,1,1,1,0
364,306,342,-58,-22,0.372325608556191,0.4727873429992803,0.15488704844452855,0.439887300755531,0.4308126067990064,0.12930009244546245,1,1,3,4,4,1,0
356,245,283,-111,-73,0.4635829438517896,0.4223608193314774,0.11405623681673299,0.5290014831313716,0.35878155928214384,0.11221695758648458,0,1,1,1,1,1,0
336,213,364,-123,28,0.5213601453482061,0.3850336501400214,0.09360620451177254,0.37813719178898364,0.510958962461637,0.1109038457493792,1,0,1,1,2,0,0
316,180,254,-136,-62,0.4255987573938924,0.4556445158055222,0.11875672680058529,0.44251877951582275,0.4410268348527663,0.1164543856314111,1,0,1,1,2,1,0
305,272,283,-33,-22,0.44293080557283904,0.4396977813603156,0.11737141306684526,0.46488015415453326,0.42258712039434587,0.1125327254511206,0,0,1,1,0,1,0
323,158,213,-165,-110,0.2367018158155978,0.6463603692124154,0.1169378149719868,0.42474044867393057,0.4659452504976905,0.10931430082837884,0,0,5,2,0,1,0
336,391,412,55,76,0.32547232419419503,0.5633711363912678,0.11115653941453704,0.40591434102817303,0.48551757480653696,0.10856808416529011,1,0,1,4,2,0,1
228,257,272,29,44,0.35601527752875956,0.48946016537491,0.15452455709633053,0.4386424717558483,0.44455116452689697,0.11680636371725471,0,0,2,1,0,0,1
320,274,287,-46,-33,0.3447744432351536,0.5347984526568036,0.12042710410804283,0.4253924308883615,0.4639528524406123,0.11065471667102614,0,1,4,3,1,1,0
456,256,273,-200,-183,0.4151225299762209,0.48482607752286677,0.1000513925009123,0.4600704646012169,0.42955499741643055,0.11037453798235262,1,1,1,2,4,1,0
288,359,369,71,81,0.48200735255109867,0.41988443171819706,0.09810821573070422,0.4315362799530924,0.4572108516253886,0.11125286842151896,1,0,1,1,2,0,1
276,201,251,-75,-25,0.45727715299960575,0.4235972239327021,0.11912562306769227,0.45609742084965754,0.4318542819231743,0.1120482972271683,1,1,3,2,4,1,0
265,211,249,-54,-16,0.37471840298006326,0.4958729512940816,0.12940864572585484,0.43563569322587,0.4518048109429364,0.11255949583119368,0,1,1,2,1,1,0
345,200,307,-145,-38,0.39340832442366225,0.4623861159347101,0.14420555964162782,0.4143015038742433,0.4751315409307177,0.110566955195039,0,1,1,1,1,1,0
415,209,363,-206,-52,0.4548298467187537,0.41700710232499755,0.12816305095624883,0.4534358845802059,0.4369930287748108,0.10957108664498334,1,1,3,2,4,1,0
182,105,162,-77,-20,0.4566102857828724,0.42757660999943276,0.11581310421769463,0.5199586139163342,0.36508085138377877,0.11496053469988685,0,1,1,1,1,1,0
287,184,240,-103,-47,0.340641153855828,0.544947615921731,0.11441123022244104,0.3821529724905763,0.5068190176286961,0.1110280098807276,1,1,1,1,4,1,0
356,227,307,-129,-49,0.5191482524278329,0.3700339236388195,0.11081782393334783,0.49780271829785244,0.3909022306165397,0.11129505108560789,0,1,1,1,1,1,0
172,16,71,-156,-101,0.44504947186933996,0.4376810445274124,0.11726948360324767,0.49397893218375194,0.3930529525338578,0.11296811528238986,0,1,2,1,1,1,0
155,47,133,-108,-22,0.5046185379764574,0.38497618019578195,0.1104052818277609,0.4447960869387069,0.44200887108444425,0.11319504197684871,1,1,1,1,4,1,0
818,522,623,-296,-195,0.2612848648440804,0.585083371696377,0.15363176345954255,0.39267705893966803,0.4997025027284802,0.1076204383318517,0,1,1,2,1,1,0
288,216,252,-72,-36,0.39250210201540936,0.48828514160663733,0.11921275637795303,0.45976271776609023,0.4241640592104546,0.11607322302345527,0,1,1,2,1,1,0
301,263,286,-38,-15,0.3518118809695052,0.5244044149328877,0.12378370409760735,0.4071343905530414,0.4752419267266804,0.11762368272027808,1,1,3,1,4,1,0
323,307,365,-16,42,0.35002104178634563,0.5401206253574473,0.1098583328562072,0.5369929585760109,0.3448102755919897,0.11819676583199926,0,1,3,1,1,0,0
371,277,360,-94,-11,0.3115636434901773,0.5669189618141988,0.12151739469562395,0.4139306158848269,0.4747271938147625,0.11134219030041058,1,1,2,1,4,1,0
748,640,669,-108,-79,0.2702656136153236,0.611407618453819,0.11832676793085752,0.5170376625451755,0.3681204088263848,0.11484192862843988,0,1,1,1,1,1,0
310,321,350,11,40,0.4133521069202092,0.46801505561505924,0.11863283746473162,0.47312198105403075,0.41148690920965,0.1153911097363191,1,1,1,1,4,0,1
330,342,438,12,108,0.44833165503864786,0.44326544662525397,0.10840289833609847,0.5072607543334234,0.37573090124959546,0.11700834441698105,1,1,4,4,4,0,1
328,185,224,-143,-104,0.4204773509240319,0.46875086992120446,0.11077177915476366,0.5420735163588811,0.34348679283856137,0.11443969080255761,0,1,1,1,1,1,0
313,245,274,-68,-39,0.5041098933323133,0.3855214912977196,0.11036861536996705,0.4420277496645612,0.44715733660515106,0.1108149137302879,0,1,1,1,1,1,0
280,177,205,-103,-75,0.3929078112572888,0.49713445422841895,0.10995773451429236,0.3678723152817305,0.5186564403376952,0.11347124438057414,1,1,1,1,4,1,0
333,209,248,-124,-85,0.39386884120853016,0.4779907933073993,0.12814036548407032,0.4110003311844708,0.4781898990940887,0.11080976972144013,1,1,2,2,4,1,0
93,12,67,-81,-26,0.4814564457552668,0.4066759295153337,0.11186762472939932,0.4544525172800572,0.4345008865579592,0.11104659616198401,0,1,2,1,1,1,0
362,312,332,-50,-30,0.4493876654001814,0.4341525406307076,0.11645979396911102,0.48724307489753865,0.4001073065340719,0.11264961856838956,1,1,2,1,4,1,0
285,159,276,-126,-9,0.4233348033243201,0.45355389074863994,0.1231113059270396,0.4388378673750253,0.45104633188818005,0.11011580073679442,1,1,2,2,4,1,0
296,191,213,-105,-83,0.5025414708377214,0.3862247311222753,0.11123379804000322,0.3899317183138628,0.49729736687929177,0.1127709148068456,0,1,2,1,1,1,0
453,406,415,-47,-38,0.328367787230813,0.5404710036956754,0.13116120907351161,0.44487929157531264,0.44623244554867847,0.10888826287600868,1,1,2,1,4,1,0
343,359,431,16,88,0.38505055127502247,0.49239213014521593,0.1225573185797616,0.4164490100704299,0.47292636215895045,0.11062462777061946,1,1,2,1,4,0,1
384,283,321,-101,-63,0.3534125067640042,0.5406653928127182,0.10592210042327771,0.4144688797168766,0.4751636140540832,0.1103675062290401,0,1,1,1,1,1,0
380,280,333,-100,-47,0.42700418719261707,0.45965639918195916,0.11333941362542363,0.44873558408093694,0.43854232360846646,0.1127220923105967,1,1,3,4,4,1,0
249,149,183,-100,-66,0.5069858209739492,0.3937896015733791,0.09922457745267194,0.4518641701090702,0.43726968983861686,0.11086614005231307,0,1,2,1,1,1,0
341,190,262,-151,-79,0.4786637758014697,0.40032021802940976,0.12101600616912052,0.5815194253394743,0.30149073023251566,0.1169898444280101,0,1,2,1,1,1,0
289,173,193,-116,-96,0.4546617276781603,0.4344362361883778,0.11090203613346183,0.5343678252382982,0.3524780663689075,0.11315410839279444,1,1,1,1,4,1,0
305,223,254,-82,-51,0.5015678049086547,0.40318617796810813,0.0952460171232374,0.47404223105307675,0.4103050632414756,0.11565270570544758,0,1,1,1,1,1,0
264,231,247,-33,-17,0.4126151982271905,0.45821242754091623,0.12917237423189354,0.4372587910311882,0.4416453926443094,0.1210958163245021,0,1,1,1,1,1,0
421,334,383,-87,-38,0.21339024751095398,0.6396587688533163,0.14695098363572934,0.48258395128567977,0.38174722335100836,0.13566882536331182,1,1,1,1,4,1,0
330,252,312,-78,-18,0.43215152356844116,0.4510497026471012,0.11679877378445781,0.3709466143853367,0.5204823866369968,0.10857099897766616,1,1,2,2,4,1,0
369,229,295,-140,-74,0.40800142549334006,0.46890874133313304,0.12308983317352727,0.42539587803136725,0.46369721309515005,0.11090690887348244,0,1,1,1,1,1,0
225,262,351,37,126,0.5637936876485257,0.3249162542495546,0.11129005810192,0.3542703007392329,0.53298044601534,0.11274925324542698,1,1,1,2,4,0,1
326,242,336,-84,10,0.4042424888462,0.4400879878600789,0.15566952329372108,0.5381679612009852,0.34398918194284833,0.11784285685616613,1,1,2,2,4,0,0
121,49,131,-72,10,0.49529283633844157,0.3929136675862592,0.11179349607529923,0.45157788880805755,0.43490137645372795,0.1135207347382146,1,1,1,1,4,0,0
284,183,212,-101,-72,0.43397217650968356,0.4628254862487659,0.10320233724155085,0.45950087908495446,0.4271896570524483,0.11330946386259727,0,1,2,1,1,1,0
292,230,283,-62,-9,0.33085308286055576,0.5301942490275937,0.13895266811185078,0.4106932540694194,0.4761870779558924,0.11311966797468809,1,1,3,2,4,1,0
355,172,224,-183,-131,0.42435637065526977,0.46600215136529066,0.10964147797943967,0.3970625604949062,0.49081886946074316,0.11211857004435061,1,1,1,3,4,1,0
304,317,434,13,130,0.520229245572642,0.3624863784377602,0.11728437598959782,0.5364154398179076,0.3441477999984849,0.11943676018360748,1,1,2,1,4,0,1
280,166,219,-114,-61,0.4732814302229187,0.4226083880375743,0.10411018173950713,0.42416521854950007,0.4663173159116639,0.1095174655388358,0,1,1,3,1,1,0
273,171,223,-102,-50,0.4020437712787459,0.46870028707295874,0.1292559416482952,0.5263751339646836,0.3582416805646905,0.1153831854706259,0,1,1,2,1,1,0
300,205,260,-95,-40,0.5079450345120009,0.38203786595793277,0.1100170995300662,0.5161484161439607,0.36764187030801976,0.11620971354801964,0,1,2,2,1,1,0
553,274,413,-279,-140,0.39722560330785567,0.485066505200855,0.11770789149128923,0.5252528906993258,0.358581332408376,0.11616577689229811,0,1,1,3,1,1,0
451,426,555,-25,104,0.3308957785307782,0.5269006754855298,0.14220354598369223,0.4709429381543825,0.39411812510745625,0.13493893673816118,1,1,1,1,4,0,0
475,410,450,-65,-25,0.3181289190486449,0.5021366187588755,0.17973446219247968,0.45759048851337136,0.42939366696912923,0.11301584451749938,1,1,4,1,4,1,0
302,260,294,-42,-8,0.4051039313833017,0.4675702131961182,0.12732585542058011,0.5119327078601251,0.37590900623134227,0.11215828590853247,1,1,1,2,4,1,0
306,224,238,-82,-68,0.3477145944267326,0.5383693341236714,0.11391607144959581,0.4335925751609539,0.4524315706641551,0.11397585417489109,1,1,1,1,4,1,0
385,337,367,-48,-18,0.39755651911109857,0.49711141486005245,0.10533206602884883,0.4093081043660698,0.4772130886057261,0.113478807028204,1,1,1,1,4,1,0
269,152,234,-117,-35,0.4472045726982293,0.43962097874127776,0.11317444856049282,0.5608142319311868,0.3231652157157715,0.11602055235304135,0,1,1,1,1,1,0
334,140,179,-194,-155,0.3391597936294308,0.5237873940599365,0.13705281231063257,0.41050427561682645,0.47835552541480714,0.11114019896836642,1,1,1,1,4,1,0
125,13,98,-112,-27,0.49835232032914983,0.3862541852558876,0.11539349441496236,0.47759125935756713,0.4088885008384729,0.11352023980395974,0,1,2,1,1,1,0
275,200,238,-75,-37,0.3946099681120044,0.4915222938956574,0.11386773799233808,0.43555299693430094,0.4528915929848067,0.11155541008089227,1,1,2,2,4,1,0
369,327,340,-42,-29,0.3018802369056409,0.5905305083274309,0.1075892547669281,0.4406759227586069,0.4491838580434505,0.11014021919794245,1,1,1,3,4,1,0
360,265,307,-95,-53,0.360204988087558,0.5223563142637246,0.11743869764871735,0.42792450443232183,0.4610853384168643,0.11099015715081381,1,1,1,1,4,1,0
327,233,280,-94,-47,0.49676418106760384,0.400208667984793,0.10302715094760335,0.4792484516842699,0.4101766458484026,0.11057490246732764,1,1,1,1,4,1,0
287,188,248,-99,-39,0.4917486372649896,0.37931108828559934,0.12894027444941097,0.5192314153633941,0.36685753688162515,0.11391104775498045,0,1,1,1,1,1,0
328,122,265,-206,-63,0.47614689400662424,0.41335071597844214,0.11050239001493346,0.45690695962194156,0.4259953259644867,0.11709771441357167,1,1,2,1,4,1,0
288,222,263,-66,-25,0.5065905975237994,0.38903026312955113,0.10437913934664939,0.5273999791063926,0.3496064011488618,0.12299361974474549,1,1,1,1,4,1,0
280,149,224,-131,-56,0.4858756668863852,0.38964353659499934,0.12448079651861516,0.4370250370547203,0.44565896232587443,0.117316000619405,0,1,1,1,1,1,0
513,455,487,-58,-26,0.3771945813814501,0.4794525470846388,0.14335287153391088,0.5297483437188457,0.34813268016793003,0.1221189761132244,1,1,1,2,4,1,0
461,397,482,-64,21,0.5265348822068314,0.3752669366397508,0.09819818115341777,0.37032690301442667,0.5184952509771249,0.11117784600844867,1,1,2,4,4,0,0
352,243,321,-109,-31,0.40890941441016004,0.44850695571304955,0.14258362987679035,0.41172558022495037,0.47512710207553466,0.11314731769951508,1,1,1,1,4,1,0
283,94,120,-189,-163,0.5046185379764574,0.38497618019578195,0.1104052818277609,0.4447960869387069,0.44200887108444425,0.11319504197684871,0,1,1,1,1,1,0
288,308,352,20,64,0.3755572762946061,0.5114776061644857,0.11296511754090817,0.3904641777657212,0.5000386500949088,0.10949717213937006,1,1,2,4,4,0,1
334,365,391,31,57,0.37923698902486414,0.5026769444496458,0.11808606652548966,0.3374720586253693,0.5510301317054755,0.11149780966915514,0,1,4,5,1,0,1
386,197,324,-189,-62,0.4788360341391571,0.40829277155119703,0.11287119430964572,0.5282300727936095,0.35082784375274817,0.12094208345364257,1,1,3,1,4,1,0
465,228,309,-237,-156,0.44978558655761386,0.43676534690573265,0.11344906653665353,0.4681237142158365,0.4152010215420975,0.11667526424206592,1,1,2,1,4,1,0
414,346,376,-68,-38,0.44094939830430985,0.4287043937331871,0.1303462079625032,0.43170459899914543,0.45730418750886725,0.11099121349198723,0,1,1,2,1,1,0
389,268,376,-121,-13,0.5262712922548446,0.3088046195327548,0.1649240882124006,0.5129156185213839,0.36444690501063204,0.12263747646798387,0,1,1,4,1,1,0
420,386,491,-34,71,0.3905063998037065,0.49247055754758884,0.11702304264870433,0.4132401359425468,0.475049656659311,0.11171020739814216,0,1,1,1,1,0,0
520,210,403,-310,-117,0.20861725099106487,0.640438266307337,0.15094448270159824,0.5481101247725799,0.34055926520078894,0.11133061002663115,1,1,4,1,4,1,0
290,163,234,-127,-56,0.37570030985917635,0.49099333008623197,0.13330636005459162,0.37192955982975073,0.5172898274358267,0.11078061273442245,1,1,1,2,4,1,0
330,244,301,-86,-29,0.45948273566345943,0.41501489692915955,0.12550236740738105,0.4065154834815401,0.4838389481398118,0.10964556837864817,1,1,1,2,4,1,0
400,328,375,-72,-25,0.46217283535522347,0.42386738867735646,0.11395977596742003,0.4215671362463577,0.4648144687746576,0.1136183949789848,1,1,1,2,4,1,0
283,167,261,-116,-22,0.5422414386706427,0.3568936100303054,0.1008649512990521,0.44884179114608025,0.43939383817633204,0.11176437067758786,1,1,2,1,4,1,0
356,369,427,13,71,0.4815763808753242,0.4107135949034318,0.10771002422124415,0.4068998583386021,0.47406688595164354,0.11903325570975445,1,1,1,1,4,0,1
234,156,299,-78,65,0.4951311937772984,0.40331890700792294,0.10154989921477857,0.47409005430294365,0.41097402476476275,0.11493592093229368,1,1,1,1,4,0,0
266,103,168,-163,-98,0.46250754230166347,0.4193325721591343,0.11815988553920227,0.4816859526845838,0.406212441350437,0.11210160596497937,1,1,2,1,4,1,0
459,347,404,-112,-55,0.46396094920539394,0.41827384401270096,0.11776520678190519,0.43741230648595175,0.45158607058862943,0.11100162292541879,1,1,1,2,4,1,0
405,378,445,-27,40,0.328070262332256,0.5128296475284863,0.15910009013925802,0.41995631821719154,0.45077728571704034,0.1292663960657682,1,1,1,2,4,0,0
310,250,276,-60,-34,0.3603432232452766,0.5231501335930444,0.1165066431616788,0.5401025144149628,0.3382683012941875,0.1216291842908495,1,1,5,1,4,1,0
480,113,314,-367,-166,0.4889728387154063,0.39287153838988437,0.1181556228947093,0.543588138909105,0.3412590531154581,0.11515280797543705,1,1,1,1,4,1,0
281,215,240,-66,-41,0.39801553264887235,0.45245179116388007,0.14953267618724736,0.45677059141674237,0.4244488389834225,0.11878056959983492,0,1,1,1,1,1,0
254,301,332,47,78,0.4170074450006046,0.48453434367800025,0.09845821132139498,0.36413808081459886,0.5226787882682888,0.11318313091711232,1,1,1,2,4,0,1
280,203,222,-77,-58,0.42951429512338385,0.44857221265114805,0.12191349222546803,0.49528958591485617,0.3863473869763183,0.11836302710882535,0,1,1,1,1,1,0
365,315,335,-50,-30,0.39043980980827697,0.4857250468570219,0.12383514333470111,0.5263105531314579,0.35513324427718046,0.1185562025913616,1,1,1,1,4,1,0
623,402,497,-221,-126,0.2959735990453012,0.5830773833853476,0.12094901756935104,0.4270964411899885,0.4601471825974541,0.11275637621255724,1,1,1,3,4,1,0
408,215,293,-193,-115,0.3365022060373397,0.5336852011572801,0.12981259280538016,0.38679698011678476,0.5016908542837336,0.11151216559948164,1,1,1,2,4,1,0
285,311,335,26,50,0.24055091125496236,0.6282770120743941,0.1311720766706434,0.4114823751938524,0.47563671038149274,0.11288091442465498,1,1,1,1,4,0,1
299,60,97,-239,-202,0.3727488972054817,0.5016508163914553,0.1256002864030631,0.4037651749730876,0.48487010889472193,0.11136471613219039,0,1,1,2,1,1,0
426,222,241,-204,-185,0.24147245003319812,0.6363253478252865,0.12220220214151557,0.3250298140349891,0.5623163252013483,0.11265386076366259,0,1,1,2,1,1,0
354,263,315,-91,-39,0.3241159644172252,0.5447037685596726,0.13118026702310237,0.4204511896882695,0.46746220707506714,0.11208660323666333,1,1,1,1,4,1,0
382,224,355,-158,-27,0.5989375294734419,0.3234455600722149,0.07761691045434309,0.5282181214910654,0.35260994152008623,0.11917193698884833,0,1,2,1,1,1,0
269,188,220,-81,-49,0.5636994664802976,0.32530018131227056,0.11100035220743185,0.4895088918789605,0.3992547680757421,0.11123634004529712,1,1,2,1,4,1,0
260,238,249,-22,-11,0.426024197226645,0.45397553103049015,0.12000027174286465,0.425416533412082,0.4588149769313155,0.11576848965660268,1,1,1,1,4,1,0
368,246,347,-122,-21,0.3858265203017778,0.48983047623914466,0.12434300345907727,0.4547091237337162,0.43346848291451917,0.11182239335176482,0,1,2,1,1,1,0
323,264,335,-59,12,0.45405328365902725,0.4425931257766968,0.10335359056427573,0.4290866151690904,0.4592054157223584,0.11170796910855105,1,1,2,2,4,0,0
305,176,214,-129,-91,0.5046185379764574,0.38497618019578195,0.1104052818277609,0.4447960869387069,0.44200887108444425,0.11319504197684871,0,1,1,1,1,1,0
279,237,297,-42,18,0.5031107479351331,0.3914851038381213,0.10540414822674574,0.47803905428070687,0.40527647063378186,0.11668447508551144,1,1,1,1,4,0,0
354,268,521,-86,167,0.44442695698980744,0.42679282955039294,0.12878021345979934,0.5315019658172321,0.35187462974076655,0.11662340444200124,1,1,1,1,4,0,0
376,221,282,-155,-94,0.4089954878173169,0.450638269562121,0.14036624262056188,0.5008375147278569,0.38841944247846333,0.11074304279367991,0,1,2,1,1,1,0
397,328,447,-69,50,0.20263944893318436,0.674731473551679,0.1226290775151362,0.3773407079407627,0.5086946388408038,0.11396465321843338,1,1,1,3,4,0,0
141,0,88,-141,-53,0.45245265401352597,0.4284692122616383,0.11907813372483601,0.5009554396531404,0.3840063739239209,0.11503818642293873,1,1,2,1,4,1,0
428,301,358,-127,-70,0.31913841144972355,0.5883699190821319,0.09249166946814452,0.45659063969815067,0.42602783937310007,0.11738152092874965,0,1,2,3,1,1,0
109,0,57,-109,-52,0.4206410274639192,0.46808882141213426,0.11127015112394652,0.48185737084363406,0.4043572746208274,0.11378535453553888,0,1,2,1,1,1,0
127,12,25,-115,-102,0.5046185379764574,0.38497618019578195,0.1104052818277609,0.4447960869387069,0.44200887108444425,0.11319504197684871,1,1,2,1,4,1,0
326,170,365,-156,39,0.49026346108223745,0.38083436460585945,0.12890217431190312,0.3289590046251129,0.5606630281083742,0.11037796726651285,1,1,2,1,4,0,0
305,221,276,-84,-29,0.4386064348088725,0.4487314822852331,0.11266208290589458,0.4213296179632678,0.46683836211591784,0.11183201992081454,1,1,2,2,4,1,0
326,132,269,-194,-57,0.3616998945671406,0.5309520309571042,0.10734807447575545,0.3975148074298153,0.4882286889325703,0.11425650363761432,0,1,1,1,1,1,0
362,243,641,-119,279,0.5366058882979099,0.3455372910610206,0.11785682064106942,0.48992114176867946,0.39591270383975924,0.11416615439156129,1,1,1,1,4,0,0
306,176,214,-130,-92,0.41235043024340207,0.4896369133370849,0.09801265641951278,0.436698630617828,0.4517748589341569,0.11152651044801512,1,1,2,3,4,1,0
282,166,221,-116,-61,0.44139427886833094,0.4383427584106404,0.12026296272102863,0.42235939262284133,0.46483368782334866,0.11280691955380959,1,1,1,2,4,1,0
365,305,344,-60,-21,0.28969995411220156,0.5873381309775333,0.122961914910265,0.5066217866307982,0.38359094306735736,0.10978727030184449,0,1,4,4,1,1,0
321,196,305,-125,-16,0.45864305720575593,0.42101856456535,0.12033837822889418,0.4383310419553414,0.45107827286267005,0.11059068518198832,1,1,1,1,4,1,0
306,167,233,-139,-73,0.37031150573233856,0.5125087243855574,0.11717976988210382,0.4123027759371482,0.4761122211113056,0.11158500295154589,1,1,2,1,4,1,0
268,201,243,-67,-25,0.46166205720933673,0.408030036132071,0.13030790665859246,0.4859033453185751,0.38623856182317723,0.1278580928582477,1,1,1,1,4,1,0
274,214,253,-60,-21,0.3956776308283702,0.49114710873360906,0.11317526043802073,0.37267690488185395,0.5138862712335214,0.1134368238846244,1,1,3,3,4,1,0
339,247,321,-92,-18,0.566905146041686,0.30288476498109146,0.13021008897722253,0.46835906153781226,0.4213082214718252,0.11033271699036251,0,1,1,3,1,1,0
353,225,291,-128,-62,0.39289049538694837,0.4853613410410585,0.12174816357199307,0.369296181304318,0.5223336313748806,0.10837018732080123,1,1,1,1,4,1,0
347,374,418,27,71,0.37135548784030803,0.5138336466289545,0.11481086553073755,0.46751268807524277,0.4151106558185788,0.1173766561061784,0,1,1,1,1,0,1
250,188,210,-62,-40,0.39074888839411615,0.49094998264368434,0.11830112896219946,0.4935941050249288,0.39691770380772085,0.10948819116735037,1,1,2,1,4,1,0
157,73,140,-84,-17,0.5115985305285293,0.3700179597965808,0.11838350967488993,0.5239623734529509,0.3571245399833256,0.11891308656372339,0,1,3,1,1,1,0
147,76,136,-71,-11,0.4507048819415136,0.42959660294415686,0.1196985151143292,0.5069121330719126,0.37874272162294226,0.11434514530514481,1,1,3,1,4,1,0
259,212,247,-47,-12,0.45903813085378825,0.41688612622153226,0.12407574292467942,0.47938180706263456,0.40968185051581474,0.11093634242155045,1,1,1,2,4,1,0
281,244,266,-37,-15,0.3976618771830882,0.4851157829222814,0.11722233989463021,0.37635524616230265,0.5111996730395633,0.11244508079813384,0,1,1,3,1,1,0
393,293,372,-100,-21,0.39331213850662455,0.47730405700339934,0.12938380448997613,0.3810409946396696,0.5080837822223025,0.11087522313802796,0,1,1,1,1,1,0
356,232,322,-124,-34,0.5089835992166315,0.36532164691243113,0.1256947538709376,0.4491132199788408,0.4255342661000212,0.1253525139211377,1,1,1,1,4,1,0
301,249,274,-52,-27,0.38868274078927223,0.493897956977558,0.11741930223316963,0.39213478253414485,0.49740024156881524,0.1104649758970401,1,1,2,2,4,1,0
426,329,401,-97,-25,0.473865928484047,0.4276470830712008,0.09848698844475215,0.5295222978358655,0.3566772735259516,0.113800428638183,1,1,1,1,4,1,0
298,221,236,-77,-62,0.34944685423811833,0.5199676540740706,0.13058549168781128,0.42678634379279706,0.461000886624238,0.11221276958296522,1,1,1,2,4,1,0
253,149,204,-104,-49,0.4523402102521289,0.4283867925396464,0.11927299720822444,0.48319665530247746,0.4015623668280071,0.11524097786951547,0,1,2,1,1,1,0
231,119,137,-112,-94,0.3796008973236795,0.4657236764725124,0.1546754262038079,0.4652692315139733,0.41411043369424255,0.1206203347917843,0,1,1,2,1,1,0
421,296,339,-125,-82,0.47175349808398215,0.40864119014311734,0.11960531177290061,0.44786574471852353,0.44149064967508933,0.11064360560638725,1,1,1,1,4,1,0
126,0,108,-126,-18,0.501883596155054,0.37644749065031996,0.12166891319462601,0.49821517747995575,0.3867678271630976,0.11501699535694693,0,1,1,1,1,1,0
534,463,503,-71,-31,0.45653817934869007,0.39814575683994463,0.14531606381136541,0.4311812445353434,0.4587288406829362,0.11008991478172031,0,1,1,2,1,1,0
286,213,223,-73,-63,0.3684816681241849,0.4931235354989768,0.13839479637683816,0.41867065003305737,0.4560435794064103,0.12528577056053228,0,1,1,1,1,1,0
337,220,271,-117,-66,0.37314960584605716,0.5029582315783958,0.12389216257554726,0.37949525519814303,0.5098405143629013,0.11066423043895547,0,1,1,1,1,1,0
449,399,417,-50,-32,0.1969403204029767,0.6967129400273029,0.10634673956972057,0.37889570349937546,0.5161173765627983,0.10498691993782618,1,1,4,1,4,1,0
128,0,112,-128,-16,0.4237834299933357,0.4539156772867941,0.12230089271987032,0.5076550972073052,0.3775922750451907,0.11475262774750437,0,1,1,1,1,1,0
153,89,118,-64,-35,0.5120133149424136,0.3711476505052112,0.1168390345523752,0.4594928690641267,0.42433788039082504,0.11616925054504823,1,1,1,1,4,1,0
169,183,303,14,134,0.31816952627685263,0.5702307438269683,0.11159972989617906,0.47184924836239095,0.410120424066069,0.11803032757154007,1,1,2,1,4,0,1
451,273,363,-178,-88,0.34046791908487767,0.5247359036573918,0.13479617725773052,0.4855344243845755,0.3944700061047717,0.11999556951065292,0,1,2,1,1,1,0
228,194,239,-34,11,0.4687381963130463,0.4349642747710398,0.09629752891591373,0.4102749057796885,0.4778018721669556,0.11192322205335573,1,1,1,2,4,0,0
251,124,170,-127,-81,0.42799262267090193,0.4439938720450072,0.12801350528409103,0.3911141701041402,0.4903557851654014,0.11853004473045839,1,1,2,1,4,1,0
349,297,329,-52,-20,0.39016141350474154,0.48113878524908366,0.1286998012461749,0.43296802241827886,0.4572767651872571,0.10975521239446404,1,1,1,2,4,1,0
435,289,418,-146,-17,0.428153585532029,0.4501660668885108,0.12168034757946028,0.5664226703480798,0.319132630349765,0.11444469930215517,0,1,1,1,1,1,0
192,0,83,-192,-109,0.5046185379764574,0.38497618019578195,0.1104052818277609,0.4447960869387069,0.44200887108444425,0.11319504197684871,0,1,1,1,1,1,0
293,167,267,-126,-26,0.4805055990060919,0.42411280111561744,0.09538159987829077,0.4950741866593009,0.3895093693075318,0.11541644403316745,0,1,2,1,1,1,0
313,248,271,-65,-42,0.4247534418764162,0.45091385773573744,0.12433270038784636,0.41625770285244,0.4732942280361783,0.11044806911138166,1,1,2,3,4,1,0
297,217,267,-80,-30,0.4899128425124492,0.3961624485301104,0.11392470895743997,0.45281512864654083,0.437340816707457,0.10984405464600187,0,1,1,1,1,1,0
315,249,288,-66,-27,0.4554950405432688,0.42186576489979116,0.12263919455693986,0.3904979140655928,0.4977071715425497,0.11179491439185742,1,1,2,2,4,1,0
463,409,437,-54,-26,0.32695836605759365,0.5556824440952288,0.11735918984717739,0.4039686480892367,0.48419347321348044,0.11183787869728277,0,1,4,1,1,1,0
360,305,346,-55,-14,0.4058097645420044,0.4665845769911544,0.1276056584668413,0.4723227954679682,0.4180300017558839,0.10964720277614781,1,1,2,1,4,1,0
405,317,433,-88,28,0.29716056058124396,0.547850689538499,0.1549887498802568,0.33404471239826344,0.5554968760145319,0.11045841158720426,1,1,2,3,4,0,0
270,16,27,-254,-243,0.48290366730379664,0.391755958174828,0.12534037452137528,0.38754805554420324,0.49177382769669714,0.12067811675909974,0,1,1,1,1,1,0
416,290,342,-126,-74,0.39453374978955535,0.4809520209878829,0.12451422922256163,0.3522092480348087,0.536899989144849,0.11089076282034233,0,1,1,1,1,1,0
374,317,328,-57,-46,0.3353744619878807,0.5309585170560595,0.13366702095605945,0.39718151658583095,0.4902805990665837,0.11253788434758523,1,1,1,1,4,1,0
350,293,309,-57,-41,0.4437268719658373,0.44598544419530756,0.11028768383885505,0.5352510914045318,0.34336236555522726,0.12138654304024103,0,1,1,1,1,1,0
406,375,417,-31,11,0.39941037336428725,0.4664605635521451,0.13412906308356776,0.44436643525158936,0.443132369552073,0.11250119519633779,1,1,2,2,4,0,0
343,243,309,-100,-34,0.47323325589844717,0.4284613411481805,0.09830540295337246,0.450412704932392,0.43286165276290456,0.11672564230470335,1,1,2,3,4,1,0
92,67,76,-25,-16,0.474208373098003,0.42317531507621015,0.10261631182578666,0.43980347683277615,0.44319728125091074,0.11699924191631299,0,1,1,1,1,1,0
382,180,307,-202,-75,0.5055062599478661,0.39059356667087985,0.10390017338125417,0.47849503085157774,0.4064102670763717,0.11509470207205034,0,1,1,1,1,1,0
399,290,341,-109,-58,0.3788197999682209,0.43113497581526866,0.19004522421651052,0.5449220425836377,0.334725735653401,0.12035222176296106,0,1,1,2,1,1,0
176,117,168,-59,-8,0.4516741447121233,0.4310137801331645,0.11731207515471212,0.48782431787199404,0.3950989045524899,0.1170767775755165,1,1,2,2,4,1,0
296,249,282,-47,-14,0.4714747811256071,0.4138463139819533,0.11467890489243988,0.4436094969307473,0.4474839119537113,0.10890659111554145,0,1,3,1,1,1,0
323,279,308,-44,-15,0.3602425119672891,0.5218805025573812,0.11787698547532965,0.32120284314019903,0.5658750451228812,0.11292211173691924,1,1,1,3,4,1,0
322,263,282,-59,-40,0.43215852257938403,0.46270879967808304,0.10513267774253304,0.48645337713515535,0.4019471985245521,0.11159942434029227,1,1,1,1,4,1,0
404,291,354,-113,-50,0.4879930607246277,0.36000541699103566,0.1520015222843366,0.4996916307222662,0.38141811668623904,0.11889025259149485,1,1,1,1,4,1,0
175,101,116,-74,-59,0.5499235779858881,0.33122921111623926,0.11884721089787216,0.4822977122731661,0.40477242941274855,0.1129298583140852,1,1,2,1,4,1,0
446,406,435,-40,-11,0.45526375153472154,0.4162545104309417,0.12848173803433666,0.4337548964107443,0.4536708285165936,0.11257427507266192,0,1,2,2,1,1,0
152,0,36,-152,-116,0.37342970423329996,0.5032035920104199,0.12336670375628028,0.4534590429425566,0.4347668279826513,0.11177412907479192,1,1,1,1,4,1,0
381,332,347,-49,-34,0.43523656543460265,0.4526257741697244,0.11213766039567293,0.3978636217411809,0.4908856805025634,0.11125069775625565,1,1,1,1,4,1,0
257,204,234,-53,-23,0.4794740243194787,0.42861786483531544,0.09190811084520566,0.475999191321127,0.4154849755504387,0.1085158331284345,0,1,1,1,1,1,0
277,145,241,-132,-36,0.5048659088798477,0.3770991840580629,0.11803490706208912,0.4261825549483225,0.4612950565182435,0.11252238853343417,1,1,1,1,4,1,0
290,155,250,-135,-40,0.4542767844454823,0.42579804835645807,0.11992516719805986,0.49340520509048075,0.3904054456651858,0.11618934924433336,0,1,1,1,1,1,0
290,256,267,-34,-23,0.38331485214945493,0.493051992723536,0.12363315512700877,0.4585859905000199,0.4202369545121558,0.12117705498782418,1,1,1,1,4,1,0
479,221,233,-258,-246,0.37159143341197526,0.490616749500087,0.1377918170879379,0.4043233110092548,0.4665914590602702,0.12908522993047503,1,1,1,1,4,1,0
434,463,504,29,70,0.46773387409163364,0.4054374548197605,0.12682867108860574,0.46497309746559506,0.4183533016573906,0.11667360087701409,1,1,2,2,4,0,1
448,379,390,-69,-58,0.40769935313328803,0.4850885806754623,0.10721206619124976,0.45429396535513045,0.43916488941991333,0.10654114522495634,0,1,1,1,1,1,0
101,0,75,-101,-26,0.46389721651090776,0.4284841642881918,0.10761861920090043,0.4804075770741734,0.40652384114884715,0.11306858177697936,0,1,1,1,1,1,0
156,131,170,-25,14,0.49405531403249414,0.395795672063439,0.11014901390406684,0.4520903712423466,0.43510295672905486,0.11280667202859855,1,1,1,2,4,0,0
578,491,565,-87,-13,0.43904519565586925,0.4272276392283138,0.13372716511581687,0.4493760436891709,0.4385316346713778,0.11209232163945104,1,1,1,4,4,1,0
337,242,303,-95,-34,0.4956461183365669,0.382255859577681,0.12209802208575239,0.44259221889760536,0.43039676281628486,0.1270110182861097,1,1,1,2,4,1,0
308,267,287,-41,-21,0.4410730576059889,0.42482507179719475,0.13410187059681614,0.4466379843123151,0.426975661604203,0.12638635408348198,0,1,1,1,1,1,0
227,144,201,-83,-26,0.37739868207302096,0.49365703336480293,0.12894428456217652,0.5258517415899455,0.36353946290208156,0.11060879550797292,0,1,2,1,1,1,0
383,321,357,-62,-26,0.43269473569906186,0.4544417617688741,0.11286350253206398,0.45905820921977714,0.4306810769896352,0.11026071379058747,0,1,4,1,1,1,0
468,432,460,-36,-8,0.35557306221237717,0.526690225043842,0.11773671274378086,0.4392300943353095,0.4448737478721765,0.11589615779251401,1,1,1,5,4,1,0
333,274,311,-59,-22,0.4497240141622949,0.413513832669806,0.13676215316789891,0.350930231380792,0.5413864510477461,0.10768331757146171,1,1,1,1,4,1,0
432,272,397,-160,-35,0.4305020123371719,0.46440622281741817,0.10509176484540987,0.5034129387030895,0.37443242217442674,0.1221546391224838,0,1,1,1,1,1,0
343,233,271,-110,-72,0.46439608054812476,0.41605356839803126,0.11955035105384405,0.41526474917281236,0.47496461389141087,0.1097706369357767,0,1,1,1,1,1,0
353,244,257,-109,-96,0.4550316814866657,0.4318805506552236,0.11308776785811071,0.48383215667347634,0.40453487044612185,0.11163297288040193,1,1,1,1,4,1,0
194,9,161,-185,-33,0.5429968313921867,0.3518388277406359,0.10516434086717763,0.5076179979508822,0.37995180362377967,0.1124301984253382,0,1,1,1,1,1,0
311,239,273,-72,-38,0.3858662983599907,0.49068467454408743,0.12344902709592212,0.3882293568146454,0.500125306633573,0.11164533655178191,1,1,1,1,4,1,0
335,285,312,-50,-23,0.4391934761943389,0.43325423371699984,0.127552290088661,0.41893689806418943,0.4678384917623918,0.11322461017341881,1,1,2,2,4,1,0
316,143,299,-173,-17,0.47709620206476694,0.40164871191837725,0.12125508601685582,0.5245662492398907,0.3601429043467657,0.11529084641334345,1,1,1,1,4,1,0
260,162,184,-98,-76,0.46486349772079233,0.4160937891903596,0.11904271308884797,0.47059895518605466,0.41869311239708734,0.11070793241685802,0,1,1,2,1,1,0
310,200,213,-110,-97,0.44810892394571744,0.4359085531173398,0.11598252293694274,0.5314909986570062,0.3547616591309629,0.11374734221203074,0,1,2,2,1,1,0
379,321,340,-58,-39,0.3436378880918074,0.5302261619535871,0.12613594995460545,0.38921319504073626,0.48208315302525756,0.12870365193400646,1,1,1,1,4,1,0
339,281,317,-58,-22,0.29093330334497103,0.562377391068226,0.14668930558680304,0.4590051490692215,0.432797090240247,0.10819776069053155,1,1,1,2,4,1,0
302,241,247,-61,-55,0.47542457227689294,0.4276747259024946,0.09690070182061213,0.4538485240053084,0.43654192430997285,0.10960955168471855,0,1,3,2,1,1,0
197,172,225,-25,28,0.41345873425151525,0.4777698700305776,0.10877139571790735,0.5088708131994825,0.37921459544618047,0.11191459135433694,1,1,1,2,4,0,0
179,51,67,-128,-112,0.5046185379764574,0.38497618019578195,0.1104052818277609,0.4447960869387069,0.44200887108444425,0.11319504197684871,1,1,1,1,4,1,0
276,171,259,-105,-17,0.3805006417102961,0.5082620264790604,0.11123733181064362,0.4587509194962503,0.42500536595440264,0.1162437145493471,0,1,2,1,1,1,0
298,303,347,5,49,0.44692610326834586,0.45857645246595785,0.09449744426569619,0.5233063010627277,0.361075763072854,0.11561793586441835,1,1,3,4,4,0,1
250,226,293,-24,43,0.395047409859501,0.47933150725796364,0.1256210828825355,0.35458464419090296,0.533545313288042,0.11187004252105535,1,1,4,3,4,0,0
91,0,137,-91,46,0.48582721203250223,0.40265216650187124,0.11152062146562633,0.4330610145555072,0.454542784194547,0.11239620124994593,1,1,1,1,4,0,0
267,295,336,28,69,0.32293944450144907,0.5653752775286603,0.1116852779698904,0.43512072078580327,0.4438287824115572,0.1210504968026395,1,1,1,3,4,0,1
249,118,156,-131,-93,0.4574558538496677,0.43849101364985216,0.10405313250048007,0.5331825291223901,0.3463320755753807,0.12048539530222901,0,1,3,1,1,1,0
237,172,188,-65,-49,0.4227962503771717,0.4616781250454398,0.11552562457738844,0.3733095895433406,0.5153189506621016,0.1113714597945576,0,1,1,1,1,1,0
365,302,324,-63,-41,0.32835299904151466,0.5624785709448634,0.10916843001362182,0.4163863228156761,0.4696078835609801,0.11400579362334377,1,1,1,3,4,1,0
250,171,187,-79,-63,0.507866272550155,0.3817631948735113,0.11037053257633375,0.42244294826147677,0.46641858249215057,0.11113846924637254,0,1,1,2,1,1,0
262,230,237,-32,-25,0.5208350575223899,0.38004865158260315,0.09911629089500679,0.41844256766233184,0.4697958846762884,0.11176154766137947,1,1,3,2,4,1,0
300,240,258,-60,-42,0.3598554003545109,0.5164655238675094,0.12367907577797976,0.44454653945236616,0.4370504978696776,0.11840296267795636,0,1,1,1,1,1,0
87,16,49,-71,-38,0.5046185379764574,0.38497618019578195,0.1104052818277609,0.4447960869387069,0.44200887108444425,0.11319504197684871,1,1,1,2,4,1,0
286,194,318,-92,32,0.49039216995230145,0.4028707786770474,0.1067370513706508,0.4630531870832763,0.4249163483847197,0.11203046453200405,1,1,1,1,4,0,0
160,134,149,-26,-11,0.5046185379764574,0.38497618019578195,0.1104052818277609,0.4447960869387069,0.44200887108444425,0.11319504197684871,1,1,2,2,4,1,0
380,275,304,-105,-76,0.4750824977610409,0.40675690396942094,0.11816059826953836,0.3468262466787282,0.5401237222444338,0.11305003107683796,1,1,1,1,4,1,0
86,0,60,-86,-26,0.3994547752076227,0.4698036226603712,0.13074160213200625,0.4673040727014264,0.4156700676094389,0.11702585968913483,0,1,1,1,1,1,0
465,195,214,-270,-251,0.48329581182442966,0.3924029968803796,0.12430119129519072,0.4087313485454094,0.47882268554379465,0.11244596591079611,0,1,1,1,1,1,0
376,258,276,-118,-100,0.37669587203774557,0.48306542468100067,0.14023870328125368,0.49218836696593576,0.39322812468559115,0.11458350834847297,1,1,2,1,4,1,0
499,0,354,-499,-145,0.26270654494716367,0.6259017960634021,0.11139165898943443,0.4701341750484415,0.4086370208711273,0.12122880408043127,1,1,1,1,4,1,0
528,329,356,-199,-172,0.3643085201709197,0.5161913652180224,0.11950011461105763,0.5386714927804631,0.34982699686217456,0.11150151035736226,0,1,1,1,1,1,0
295,214,379,-81,84,0.5041809947729555,0.37293577540047773,0.1228832298265667,0.4566390957971509,0.43318780291050407,0.11017310129234473,0,1,1,2,1,0,0
432,393,412,-39,-20,0.3252928715114155,0.5337350918440062,0.14097203664457808,0.5664712287082463,0.3095787812015836,0.12394999009017013,1,1,1,1,4,1,0
284,185,234,-99,-50,0.43844545647877825,0.43189165521997075,0.1296628883012512,0.5086340459923704,0.3751508778611111,0.11621507614651856,0,1,2,1,1,1,0
301,182,277,-119,-24,0.4860061441888288,0.39937870737826503,0.11461514843290625,0.43387118049807566,0.4547060373789031,0.11142278212302147,1,1,2,1,4,1,0
505,418,467,-87,-38,0.4969487368421593,0.3909046185538916,0.11214664460394903,0.5375812725108693,0.3426312667742286,0.11978746071490218,1,1,1,1,4,1,0
411,577,626,166,215,0.4814372792458956,0.4173518916662838,0.10121082908782056,0.5725320218168803,0.304402420766521,0.12306555741659866,0,1,1,1,1,0,1
265,175,206,-90,-59,0.3857283944716849,0.5041652225630769,0.11010638296523795,0.4197928132516619,0.4690064747655638,0.1112007119827744,1,1,1,1,4,1,0
370,285,305,-85,-65,0.485581816346559,0.37933667011019134,0.13508151354324974,0.5324416685613018,0.35151865655554526,0.11603967488315305,1,1,1,1,4,1,0
427,380,408,-47,-19,0.4749493095813995,0.4024657437350767,0.12258494668352346,0.40351433462197234,0.48624672168714306,0.11023894369088469,0,1,2,1,1,1,0
118,17,86,-101,-32,0.4236509803070032,0.4607931051587473,0.11555591453424931,0.49473437192025677,0.38764530248874157,0.11762032559100144,0,1,1,1,1,1,0
60,45,183,-15,123,0.44909478829298405,0.43323373155094624,0.11767148015606962,0.47049236414002615,0.4121033988076877,0.11740423705228617,0,1,1,1,1,0,0
302,52,133,-250,-169,0.4430654336780317,0.4184291701126153,0.13850539620935268,0.47615328789254124,0.3990321350550595,0.1248145770523989,1,1,1,1,4,1,0
172,18,128,-154,-44,0.45725549349813144,0.42368796096661987,0.11905654553524843,0.5290812623331792,0.35627111723183347,0.1146476204349872,0,1,2,1,1,1,0
265,285,310,20,45,0.5247792578002328,0.35712608788429057,0.11809465431547667,0.5166183917966446,0.366475142937514,0.11690646526584143,1,1,3,1,4,0,1
394,184,294,-210,-100,0.46039825360384073,0.4172382587147128,0.12236348768144618,0.54428130019038,0.3418399163970057,0.11387878341261423,1,1,3,1,4,1,0
265,160,188,-105,-77,0.49270647657620087,0.36842791338401254,0.13886561003978667,0.49218173574776425,0.39190655559535365,0.11591170865688215,1,1,2,1,4,1,0
244,179,187,-65,-57,0.4906291668805417,0.3776170305211443,0.13175380259831385,0.3963083440952267,0.4912936303630556,0.1123980255417177,1,1,1,2,4,1,0
202,121,195,-81,-7,0.47293809533399805,0.4078581831672267,0.1192037214987751,0.5200105192102177,0.36376162697729825,0.11622785381248407,1,1,3,1,4,1,0
328,319,355,-9,27,0.37181341391608624,0.4953957768811261,0.13279080920278744,0.4743730072331324,0.40992075790583504,0.11570623486103243,0,1,3,2,1,0,0
347,233,324,-114,-23,0.5012511096420244,0.3671137384620284,0.1316351518959473,0.4952920606273681,0.38951090285745604,0.11519703651517581,1,1,1,1,4,1,0
301,217,255,-84,-46,0.5438354427780788,0.33393098120495096,0.12223357601696998,0.42277787315809434,0.4634194614001993,0.11380266544170632,1,1,1,1,4,1,0
389,304,366,-85,-23,0.3700360892826848,0.514460267704363,0.11550364301295218,0.4743580860509192,0.4065220526317164,0.11911986131736445,1,1,1,1,4,1,0
132,55,110,-77,-22,0.4687957872982449,0.4029831428769778,0.12822106982477696,0.42169595430074763,0.46267948614291243,0.11562455955634002,0,1,1,1,1,1,0
350,71,302,-279,-48,0.5046185379764574,0.38497618019578195,0.1104052818277609,0.4447960869387069,0.44200887108444425,0.11319504197684871,0,1,1,1,1,1,0
338,252,279,-86,-59,0.3701899126527714,0.5223547310216561,0.10745535632557235,0.3498657591738376,0.5399836459469659,0.11015059487919655,1,1,3,3,4,1,0
346,89,123,-257,-223,0.5046185379764574,0.38497618019578195,0.1104052818277609,0.4447960869387069,0.44200887108444425,0.11319504197684871,1,1,1,2,4,1,0
618,502,806,-116,188,0.29856622579950176,0.5493047978367767,0.15212897636372155,0.5373321179504215,0.3482983441435925,0.11436953790598602,1,1,1,1,4,0,0
240,199,215,-41,-25,0.36466124599903643,0.5149663207334295,0.12037243326753391,0.4267150770535091,0.46010098750771294,0.11318393543877805,1,1,1,4,4,1,0
405,217,263,-188,-142,0.4078873937666115,0.4808745595002453,0.111238046733143,0.4335244638802922,0.4538822348132534,0.11259330130645469,1,1,1,1,4,1,0
371,245,314,-126,-57,0.4993322304338456,0.40076220126004736,0.09990556830610701,0.4923789702863817,0.3919532085498638,0.11566782116375447,1,1,1,2,4,1,0
126,0,86,-126,-40,0.47629679030313515,0.3884749018902785,0.13522830780658637,0.5031284849111725,0.38163943677199663,0.11523207831683105,0,1,1,1,1,1,0
403,332,357,-71,-46,0.47955128887563364,0.403281906818298,0.1171668043060682,0.4670091471118398,0.41656751820254506,0.11642333468561546,1,1,1,1,4,1,0
250,0,213,-250,-37,0.5046185379764574,0.38497618019578195,0.1104052818277609,0.4447960869387069,0.44200887108444425,0.11319504197684871,1,1,1,2,4,1,0
245,0,148,-245,-97,0.4893532941901596,0.39800444575161226,0.11264226005822797,0.45049575203928166,0.43617595550210486,0.1133282924586136,0,1,1,1,1,1,0
267,101,136,-166,-131,0.4734404364307689,0.38950597634208056,0.13705358722715055,0.38115263616765976,0.5098153696191821,0.10903199421315861,0,1,2,1,1,1,0
288,202,255,-86,-33,0.35040568014718715,0.5250132480116142,0.12458107184119849,0.4072095564778364,0.4823571803395378,0.11043326318262574,1,1,2,3,4,1,0
298,264,359,-34,61,0.560762928136716,0.34203212466708754,0.09720494719619635,0.4607280009309584,0.4280013385790798,0.11127066048996169,1,1,1,2,4,0,0
349,291,361,-58,12,0.3573688455315015,0.5357306777939339,0.10690047667456437,0.27700249714469927,0.6092621147801556,0.11373538807514516,1,1,1,2,4,0,0
240,153,205,-87,-35,0.4980418501347245,0.3961736646336273,0.10578448523164839,0.465125950364477,0.42391848681635597,0.11095556281916688,1,1,1,2,4,1,0
263,180,229,-83,-34,0.40631032886638213,0.47024790349610013,0.12344176763751767,0.3369118394519772,0.5551726215210013,0.10791553902702122,1,1,2,1,4,1,0
322,266,300,-56,-22,0.5528867388895972,0.34793557662789865,0.09917768448250414,0.5175297154483602,0.36922309889499777,0.11324718565664209,0,1,2,1,1,1,0
289,110,233,-179,-56,0.5044405261587549,0.4018226756402843,0.09373679820096072,0.40326160575365483,0.47311218392878435,0.12362621031756074,0,1,1,1,1,1,0
388,197,259,-191,-129,0.369062463629915,0.5044332415017869,0.1265042948682983,0.49628401767970604,0.3893832761268552,0.1143327061934392,1,1,2,1,4,1,0
197,89,257,-108,60,0.5012124872864259,0.3926425282625351,0.106144984451039,0.4450190738417014,0.4432092814918153,0.11177164466648293,0,1,2,1,1,0,0
382,338,359,-44,-23,0.4199643067641017,0.4537730114823035,0.12626268175359467,0.49831971203549924,0.3844595444952784,0.11722074346922215,1,1,2,3,4,1,0
275,343,365,68,90,0.42306428222830306,0.46169203461258873,0.11524368315910816,0.4773080694179335,0.40255841321600966,0.1201335173660568,1,1,3,2,4,0,1
379,348,371,-31,-8,0.47501651222672997,0.42027033578215695,0.10471315199111303,0.5275833744084374,0.35538939560106936,0.11702722999049343,1,1,1,1,4,1,0
374,315,346,-59,-28,0.4662608107046147,0.405398518773116,0.12834067052226922,0.5200114545401194,0.3642167608663405,0.11577178459353997,1,1,1,2,4,1,0
157,88,100,-69,-57,0.48868714623124987,0.4000320648995618,0.11128078886918852,0.42870298720142996,0.4559953925452231,0.11530162025334707,0,1,1,1,1,1,0
271,118,151,-153,-120,0.5394927610582909,0.3521797040388624,0.10832753490284668,0.4708480155608574,0.4129519927155502,0.1161999917235921,1,1,2,2,4,1,0
173,186,192,13,19,0.5040027035746848,0.37813745383441055,0.11785984259090455,0.45566259316769175,0.43224421018492043,0.11209319664738791,1,1,2,2,4,0,1
264,184,225,-80,-39,0.45178331314359904,0.42515253515853757,0.1230641516978634,0.4397904360047931,0.4484847214550991,0.11172484254010742,1,1,1,1,4,1,0
123,0,90,-123,-33,0.5046185379764574,0.38497618019578195,0.1104052818277609,0.4447960869387069,0.44200887108444425,0.11319504197684871,0,1,1,1,1,1,0
295,155,261,-140,-34,0.47073348993473113,0.4201330650691085,0.10913344499616057,0.4826275001280109,0.40264898064137883,0.11472351923061007,1,1,1,2,4,1,0
235,188,225,-47,-10,0.36547032299679305,0.502190976512445,0.1323387004907619,0.43534986085664074,0.45371604699052825,0.11093409215283095,1,1,1,2,4,1,0
300,120,134,-180,-166,0.4406678798873248,0.4469601925545343,0.11237192755814089,0.43573689275907584,0.4441150646975605,0.12014804254336373,1,1,2,2,4,1,0
312,243,288,-69,-24,0.44958000536044046,0.43428634559582635,0.11613364904373313,0.47292342784515695,0.41258097918129594,0.11449559297354725,0,1,1,1,1,1,0
86,190,222,104,136,0.5046185379764574,0.38497618019578195,0.1104052818277609,0.4447960869387069,0.44200887108444425,0.11319504197684871,1,1,2,2,4,0,1
255,178,192,-77,-63,0.5127452466343548,0.36785567494060445,0.11939907842504047,0.4101301565612287,0.4779108142940526,0.11195902914471871,0,1,3,1,1,1,0
311,209,288,-102,-23,0.4577287997242745,0.4426592588958047,0.09961194137992062,0.4633467008230562,0.4222900447954483,0.11436325438149547,0,1,2,1,1,1,0
359,196,303,-163,-56,0.38115120156057114,0.4820971414500809,0.136751656989348,0.5386189140384673,0.3461602616195342,0.11522082434199858,1,1,2,1,4,1,0
399,278,345,-121,-54,0.38253977207681966,0.5178432052954105,0.09961702262776977,0.5028124070505553,0.37878056697707513,0.11840702597236939,0,1,2,1,1,1,0
273,228,260,-45,-13,0.5371225802089261,0.3408135104802608,0.122063909310813,0.5274705057654662,0.354710326800744,0.11781916743378958,0,1,3,3,1,1,0
278,193,237,-85,-41,0.4585770039349805,0.4389735318749472,0.10244946419007227,0.4624232235226464,0.4224435039347444,0.11513327254260919,1,1,2,1,4,1,0
399,291,341,-108,-58,0.3960396869153013,0.4893688189412907,0.11459149414340843,0.4917272797676437,0.3959676583584258,0.1123050618739306,1,1,1,1,4,1,0
291,198,222,-93,-69,0.3846588927290243,0.5102610501799664,0.10508005709100961,0.46152675032434826,0.42585608513834805,0.11261716453730368,0,1,1,1,1,1,0
319,357,370,38,51,0.33388522826689276,0.5443498196421818,0.12176495209092562,0.5365775404859806,0.3415265172277691,0.1218959422862503,0,1,1,2,1,0,1
435,329,396,-106,-39,0.39942370776953495,0.4715451994922283,0.12903109273823696,0.45811520866227623,0.42745580577839914,0.11442898555932486,1,1,1,1,4,1,0
342,174,226,-168,-116,0.42210508070135555,0.4794198422143977,0.0984750770842466,0.5429822149401634,0.3398367092895281,0.11718107577030856,0,1,1,1,1,1,0
412,222,355,-190,-57,0.41411399112843744,0.4693481437665603,0.11653786510500237,0.5415397816831832,0.3436938722039026,0.11476634611291436,1,1,1,1,4,1,0
310,60,102,-250,-208,0.5104051019493953,0.3828323244408853,0.10676257360971916,0.4538919100549135,0.42869384886928497,0.11741424107580144,1,1,1,1,4,1,0
307,142,221,-165,-86,0.4411008675710916,0.4335779307609111,0.12532120166799715,0.47688083289761474,0.4092911589188039,0.11382800818358112,1,1,2,1,4,1,0
231,153,256,-78,25,0.45799049649954204,0.426103752335954,0.11590575116450426,0.518837954677654,0.36756495034579867,0.11359709497654741,1,1,1,1,4,0,0
368,255,312,-113,-56,0.3970707270715095,0.48615542960389985,0.11677384332459069,0.37739954741978227,0.5128494536632686,0.10975099891694864,0,1,1,1,1,1,0
258,129,148,-129,-110,0.3680418748040206,0.5056363099611759,0.1263218152348036,0.3885833640181403,0.4983422113585943,0.11307442462326517,0,1,1,1,1,1,0
292,235,250,-57,-42,0.4370457468826609,0.43884446158507867,0.12410979153226037,0.3742575622077851,0.5166665461411393,0.1090758916510754,1,1,1,2,4,1,0
339,192,263,-147,-76,0.4079452209139037,0.4552223060558017,0.13683247303029467,0.3949972785363148,0.49505785105299577,0.10994487041068915,0,1,2,3,1,1,0
313,216,249,-97,-64,0.38116039233482957,0.5019290538759987,0.11691055378917155,0.48926628669027705,0.39358137638179497,0.1171523369279278,0,1,3,1,1,1,0
403,368,388,-35,-15,0.47806355432817055,0.4123243468813951,0.10961209879043482,0.4390269384477318,0.4510820124536014,0.1098910490986667,1,1,2,1,4,1,0
498,311,422,-187,-76,0.3452040610251544,0.5061205817578516,0.1486753572169941,0.5389858281265183,0.32128542310790625,0.1397287487655754,1,1,1,1,4,1,0
291,153,205,-138,-86,0.4870954240576987,0.39917618780850594,0.1137283881337953,0.4558555740411908,0.43093858576274857,0.1132058401960606,1,1,1,1,4,1,0
163,13,124,-150,-39,0.4745239256099341,0.4011841960427723,0.12429187834729351,0.5082267660961467,0.3709862474349814,0.12078698646887179,0,1,2,1,1,1,0
364,234,302,-130,-62,0.4873345703938365,0.40379132393219247,0.10887410567397104,0.4765400422093847,0.40719394244218854,0.11626601534842662,1,1,2,2,4,1,0
257,196,218,-61,-39,0.5254689485797335,0.3682007524572169,0.10633029896304978,0.4642457279102582,0.4195277414280577,0.11622653066168438,1,1,2,1,4,1,0
298,247,325,-51,27,0.2832232368539024,0.5902390016717266,0.1265377614743709,0.38297840960280427,0.5049342884670672,0.11208730193012849,1,1,1,2,4,0,0
345,359,381,14,36,0.4805520768069353,0.41833305266578785,0.10111487052727688,0.5141740763191027,0.3698976316746642,0.11592829200623322,0,1,5,3,1,0,1
273,229,248,-44,-25,0.4445947397042525,0.43013128348064356,0.12527397681510408,0.39660901413308725,0.4922208411078219,0.11117014475909111,1,1,2,2,4,1,0
335,124,167,-211,-168,0.512574673603196,0.37095178098868004,0.11647354540812391,0.5065204043784097,0.3797844821536245,0.11369511346796578,0,1,1,1,1,1,0
280,214,237,-66,-43,0.3985702412114114,0.4734942626829886,0.12793549610559965,0.436837955691431,0.4415246626990703,0.12163738160949854,1,1,2,3,4,1,0
197,109,181,-88,-16,0.4861765544870946,0.3678831372563445,0.14594030825656082,0.49989437696497313,0.38645329839266557,0.11365232464236132,0,1,1,1,1,1,0
100,26,47,-74,-53,0.4536398656385065,0.43714582076335007,0.10921431359814367,0.49919289740455847,0.38548962651170166,0.11531747608373975,1,1,1,1,4,1,0
444,358,374,-86,-70,0.42823391385339415,0.47840651763284503,0.093359568513761,0.4373628968579663,0.45306810129990793,0.10956900184212555,0,1,1,2,1,1,0
288,200,254,-88,-34,0.4324125266601992,0.45035199072503773,0.1172354826147634,0.45603434140613525,0.42939096305838176,0.1145746955354831,1,1,2,1,4,1,0
341,142,273,-199,-68,0.5046185379764574,0.38497618019578195,0.1104052818277609,0.4447960869387069,0.44200887108444425,0.11319504197684871,0,1,1,1,1,1,0
185,0,125,-185,-60,0.47245511814293883,0.39333127742812946,0.13421360442893154,0.5172853985013703,0.36856365037526484,0.11415095112336462,0,1,1,1,1,1,0
299,106,219,-193,-80,0.5046185379764574,0.38497618019578195,0.1104052818277609,0.4447960869387069,0.44200887108444425,0.11319504197684871,0,1,1,1,1,1,0
254,161,181,-93,-73,0.4627211974106316,0.42178399355862967,0.11549480903073862,0.434178524282818,0.4542443523804216,0.11157712333676015,0,1,1,1,1,1,0
321,201,220,-120,-101,0.38594718125501865,0.46699882273436494,0.14705399601061628,0.45274939725393654,0.41811731973657457,0.12913328300948915,0,1,2,3,1,1,0
280,165,271,-115,-9,0.5932827283361979,0.32324858734650125,0.08346868431730074,0.49816271047776123,0.3918336419455123,0.11000364757672661,0,1,1,3,1,1,0
285,111,180,-174,-105,0.4282020012772905,0.4507520494999306,0.12104594922277881,0.4173801728539376,0.46164984879281895,0.12096997835324357,1,1,1,2,4,1,0
386,269,351,-117,-35,0.34855123884265615,0.5060430494384889,0.1454057117188548,0.41316006550151724,0.47741088929242004,0.10942904520606266,0,1,1,2,1,1,0
298,224,276,-74,-22,0.42258136459970524,0.44746469139163575,0.12995394400865876,0.328856969172229,0.5593741498400226,0.11176888098774815,0,1,1,2,1,1,0
304,262,269,-42,-35,0.39363034557407417,0.5086957202797072,0.09767393414621832,0.38952607390756294,0.49886146645514945,0.11161245963728746,0,1,2,2,1,1,0
337,145,163,-192,-174,0.4812154255567981,0.4029731921969129,0.11581138224628913,0.40897564477238196,0.4749025416532003,0.11612181357441764,1,1,1,1,4,1,0
450,374,417,-76,-33,0.38145505976849126,0.49681321549151386,0.12173172473999483,0.4848883527676121,0.40244298804296813,0.11266865918941982,1,1,1,1,4,1,0
402,312,377,-90,-25,0.40773576280906043,0.47237367271406616,0.11989056447687331,0.3936104484228433,0.4966165766848261,0.10977297489233051,1,1,2,3,4,1,0
295,106,275,-189,-20,0.45274974543526963,0.42225848215869044,0.12499177240603994,0.5464735988371062,0.34130763157881355,0.11221876958407999,0,1,1,1,1,1,0
287,206,245,-81,-42,0.3481774651323048,0.5109680318818991,0.14085450298579616,0.41604791041719524,0.47092286639290293,0.11302922318990141,0,1,1,2,1,1,0
362,295,349,-67,-13,0.4971086076745602,0.4065067207452185,0.09638467158022104,0.5299134288940113,0.35545492731931466,0.11463164378667406,1,1,1,2,4,1,0
273,236,249,-37,-24,0.40930830757129383,0.46815912684907296,0.12253256557963317,0.41251270436006005,0.4783573120789256,0.10912998356101432,0,1,3,3,1,1,0
237,208,226,-29,-11,0.41575264756736463,0.48389104697700597,0.10035630545562971,0.45832091580752216,0.4299260390707893,0.11175304512168868,1,1,2,1,4,1,0
327,389,416,62,89,0.41992514746503096,0.4542630286061967,0.12581182392877244,0.4739058009716456,0.41218180938961313,0.11391238963874117,1,1,2,1,4,0,1
75,0,48,-75,-27,0.5046185379764574,0.38497618019578195,0.1104052818277609,0.4447960869387069,0.44200887108444425,0.11319504197684871,1,1,1,1,4,1,0
264,187,221,-77,-43,0.46491766999751905,0.3974257511451796,0.13765657885730134,0.4603541066078661,0.4270383538475976,0.11260753954453656,0,1,1,1,1,1,0
358,238,255,-120,-103,0.4192433007037649,0.4726730690773882,0.10808363021884712,0.5366850730704188,0.3445600082410132,0.11875491868856806,1,1,2,1,4,1,0
256,187,196,-69,-60,0.373096814935378,0.5122590818033382,0.11464410326128371,0.4603085948498938,0.42734779709728155,0.1123436080528244,1,1,3,2,4,1,0
437,273,402,-164,-35,0.2982732649255154,0.5346960043693407,0.16703073070514388,0.5440263934228664,0.33935049232207587,0.11662311425505756,0,1,1,1,1,1,0
309,155,175,-154,-134,0.4250123218742278,0.47254158886128056,0.10244608926449175,0.5214046419177362,0.36373653897084224,0.11485881911142144,0,1,2,1,1,1,0
430,456,543,26,113,0.39412825343888647,0.4798652904141778,0.12600645614693606,0.4151728875936335,0.4756376663612808,0.10918944604508578,1,1,1,1,4,0,1
195,120,180,-75,-15,0.5046185379764574,0.38497618019578195,0.1104052818277609,0.4447960869387069,0.44200887108444425,0.11319504197684871,0,1,1,1,1,1,0
407,336,356,-71,-51,0.47131040032034577,0.4304750444963521,0.09821455518330208,0.50525769471078,0.38088747428613384,0.11385483100308601,1,1,1,3,4,1,0
342,271,291,-71,-51,0.39954172226249235,0.46427809522806257,0.13618018250944475,0.3842524595835582,0.5059518230709947,0.10979571734544706,0,1,1,1,1,1,0
182,87,123,-95,-59,0.45526603174327146,0.43738549920904546,0.1073484690476831,0.45964170361743956,0.42762524169211785,0.11273305469044267,1,1,1,3,4,1,0
242,173,211,-69,-31,0.4656524655794048,0.4225743985316737,0.11177313588892154,0.4407838584945872,0.4469526956812782,0.11226344582413485,1,1,1,1,4,1,0
288,230,248,-58,-40,0.3905410889911929,0.49408295744920305,0.115375953559604,0.5202792243210533,0.35952236086446865,0.12019841481447817,1,1,1,1,4,1,0
316,295,349,-21,33,0.2764875969246914,0.5956831296425007,0.12782927343280742,0.3853529483517019,0.5052718683176383,0.1093751833306599,1,1,1,2,4,0,0
278,189,265,-89,-13,0.4557950097381436,0.43282123554117086,0.11138375472068551,0.43514727468397824,0.45460186338853037,0.11025086192749137,1,1,1,3,4,1,0
314,254,266,-60,-48,0.3992931436403066,0.4659622346577875,0.13474462170190585,0.42701085370358494,0.461623591563212,0.11136555473320323,1,1,3,2,4,1,0
410,254,301,-156,-109,0.39644605376537756,0.4644351325881835,0.13911881364643916,0.44492802120953534,0.44420880738560536,0.1108631714048592,0,1,2,1,1,1,0
290,228,244,-62,-46,0.508079505594037,0.38321644334115096,0.108704051064812,0.4377238051945331,0.4494976143344182,0.11277858047104856,1,1,2,1,4,1,0
139,87,113,-52,-26,0.5293926573686989,0.36397786883768224,0.1066294737936188,0.4559099254077531,0.42979536250607525,0.11429471208617153,1,1,3,1,4,1,0
400,252,310,-148,-90,0.5046185379764574,0.38497618019578195,0.1104052818277609,0.4447960869387069,0.44200887108444425,0.11319504197684871,1,1,1,2,4,1,0
439,315,423,-124,-16,0.3757203268600679,0.4817760384555058,0.1425036346844264,0.381827093438572,0.5071160796696317,0.1110568268917965,0,1,1,2,1,1,0
122,0,81,-122,-41,0.45500318733671646,0.4356822103002381,0.10931460236304502,0.503802600115916,0.38183587247067013,0.11436152741341386,1,1,1,1,4,1,0
332,265,301,-67,-31,0.40511008132710913,0.4712868368313315,0.1236030818415591,0.43424374806043947,0.4476874836613429,0.1180687682782176,1,1,1,1,4,1,0
520,252,308,-268,-212,0.45038967290654897,0.4164718748933484,0.1331384522001029,0.4777820541375552,0.40935259919207634,0.11286534667036834,1,1,2,1,4,1,0
318,181,476,-137,158,0.5105858203693764,0.37878293882216335,0.11063124080846046,0.5103545661140281,0.37545193740176613,0.11419349648420596,1,1,2,4,4,0,0
322,246,278,-76,-44,0.4401610853381769,0.4388498915896314,0.12098902307219195,0.38648755809795865,0.50416632889979,0.10934611300225126,1,1,1,2,4,1,0
276,207,260,-69,-16,0.47315871763648043,0.4079251712034405,0.11891611116007897,0.538796987703017,0.3434875207824342,0.11771549151454899,1,1,2,2,4,1,0
211,62,183,-149,-28,0.48001535956597624,0.4081870565937447,0.1117975838402793,0.5418602825738404,0.34708467459349973,0.11105504283265968,0,1,2,1,1,1,0
159,2,140,-157,-19,0.5046185379764574,0.38497618019578195,0.1104052818277609,0.4447960869387069,0.44200887108444425,0.11319504197684871,1,1,1,1,4,1,0
311,185,289,-126,-22,0.47832246868530326,0.40275390810165895,0.118923623213038,0.47444171565249005,0.4117598046937016,0.11379847965380817,0,1,2,1,1,1,0
248,146,233,-102,-15,0.5340828423388804,0.360394248619131,0.10552290904198872,0.44474156931304404,0.44268244652014593,0.1125759841668101,0,1,1,1,1,1,0
260,120,176,-140,-84,0.5161557176785565,0.37368742408742844,0.11015685823401516,0.4820621717159603,0.39787476921669696,0.12006305906734258,1,1,1,1,4,1,0
245,114,196,-131,-49,0.4635467857635771,0.42217323890081443,0.11427997533560842,0.47013415076595294,0.41687429817061783,0.11299155106342933,0,1,1,1,1,1,0
351,259,317,-92,-34,0.41612429565267595,0.4670137593650068,0.11686194498231695,0.40063972073658544,0.4877050765658881,0.11165520269752668,1,1,1,1,4,1,0
313,225,262,-88,-51,0.3302422983609059,0.5453064408686833,0.12445126077041092,0.3660923415284786,0.5267057607455231,0.10720189772599831,0,1,2,4,1,1,0
373,311,343,-62,-30,0.44180951188052703,0.4367791784559594,0.12141130966351331,0.4218671986871367,0.46574212320179204,0.11239067811107087,1,1,2,2,4,1,0
274,155,395,-119,121,0.4693080089658909,0.4282468863417169,0.10244510469239194,0.44069606599994376,0.4485039730514478,0.11079996094860838,1,1,2,1,4,0,0
385,349,367,-36,-18,0.5325590836728162,0.38613980670135,0.08130110962583383,0.45751059408996975,0.43155594063324537,0.11093346527678481,1,1,3,1,4,1,0
428,287,324,-141,-104,0.3304562634826909,0.5399237506663903,0.12961998585091858,0.5355744909550406,0.34661233611564946,0.11781317292930996,0,1,1,1,1,1,0
263,177,251,-86,-12,0.4365044980441039,0.4511394258747723,0.11235607608112395,0.4632926417923152,0.4230979591688795,0.11360939903880522,1,1,2,1,4,1,0
361,294,325,-67,-36,0.49304874701684426,0.41086771615745343,0.09608353682570216,0.5420429884299938,0.343585957893869,0.1143710536761373,1,1,3,3,4,1,0
321,269,295,-52,-26,0.5261647609115903,0.3607067846337987,0.11312845445461076,0.5363171655970324,0.3433170709346425,0.12036576346832538,1,1,1,3,4,1,0
418,293,315,-125,-103,0.36768115493626524,0.5292055598363294,0.10311328522740548,0.42081532976906316,0.46619694812102874,0.11298772210990816,1,1,1,2,4,1,0
468,239,436,-229,-32,0.37813737163782185,0.5099500197023363,0.11191260865984204,0.5090555611277479,0.37295074280088764,0.1179936960713646,0,1,1,1,1,1,0
161,15,89,-146,-72,0.5569250961089587,0.32958521628154674,0.11348968760949449,0.5088754341648111,0.3784901826699654,0.11263438316522344,0,1,1,1,1,1,0
336,224,269,-112,-67,0.319646327131343,0.5785851563055565,0.10176851656310039,0.47506648764142256,0.40493615752252443,0.11999735483605312,1,1,1,2,4,1,0
277,225,242,-52,-35,0.45122031956128655,0.4600754042154442,0.08870427622326954,0.4680842194204361,0.42019267533341803,0.1117231052461458,0,1,2,2,1,1,0
295,113,182,-182,-113,0.49476948568443335,0.3672601695015508,0.13797034481401563,0.516271276611715,0.3676351593464413,0.11609356404184354,0,1,1,1,1,1,0
333,231,290,-102,-43,0.3868413386658149,0.4900721329932522,0.1230865283409329,0.47099494946421794,0.41317950651810054,0.11582554401768144,0,1,1,2,1,1,0
320,278,311,-42,-9,0.27831358017814767,0.6137411884973419,0.10794523132451042,0.4375351387308435,0.45092785633103083,0.11153700493812571,1,1,1,8,4,1,0
383,167,188,-216,-195,0.40463814284194377,0.4874408626035019,0.10792099455455441,0.47403640804450226,0.41584543927250583,0.11011815268299166,1,1,1,1,4,1,0
387,308,345,-79,-42,0.38940377950092575,0.4977358022333475,0.11286041826572643,0.49247222339846564,0.39171890247678903,0.11580887412474564,1,1,2,1,4,1,0
270,281,303,11,33,0.4789738751446889,0.3995000005197308,0.1215261243355805,0.32406928199935336,0.5679067074275571,0.10802401057308975,1,1,2,2,4,0,1
347,308,328,-39,-19,0.47934444499973416,0.38819115859950537,0.13246439640076024,0.4235760348586597,0.46403833661827826,0.1123856285230619,0,1,1,1,1,1,0
322,246,266,-76,-56,0.3579943582206767,0.541257705020951,0.1007479367583719,0.44806634995920475,0.439258267925821,0.11267538211497419,0,1,2,1,1,1,0
315,386,438,71,123,0.4577916115710481,0.44459944644655247,0.09760894198239943,0.3867787525223538,0.5007945548297792,0.11242669264786714,1,1,3,3,4,0,1
377,253,346,-124,-31,0.36767281358935044,0.5203452412895131,0.1119819451211363,0.45742888203504534,0.4266860849833464,0.115885032981608,1,1,3,1,4,1,0
220,113,257,-107,37,0.5732382607651325,0.32665390452457177,0.10010783471029562,0.5392401597268398,0.3472820988302892,0.11347774144287087,0,1,1,1,1,0,0
319,247,275,-72,-44,0.3047439553477278,0.5631444773609762,0.13211156729129647,0.3826100068021751,0.5066124824933362,0.11077751070448835,0,1,1,1,1,1,0
171,0,123,-171,-48,0.529004519441238,0.3721027238505244,0.09889275670823758,0.500527821840991,0.3838286930924695,0.11564348506653951,1,1,1,1,4,1,0
286,202,243,-84,-43,0.47243779137375197,0.39777722084363154,0.12978498778261657,0.47575717808177237,0.41129273957777585,0.1129500823404521,0,1,2,5,1,1,0
262,188,206,-74,-56,0.41271263922650553,0.472496157678065,0.1147912030954292,0.48002299376307334,0.40670566162469124,0.11327134461223554,0,1,2,2,1,1,0
176,0,160,-176,-16,0.5046185379764574,0.38497618019578195,0.1104052818277609,0.4447960869387069,0.44200887108444425,0.11319504197684871,1,1,1,1,4,1,0
414,387,403,-27,-11,0.2805123287663134,0.5992745887383953,0.12021308249529135,0.40535234829994804,0.4865547796698773,0.10809287203017486,1,1,1,2,4,1,0
174,180,217,6,43,0.49594670863897017,0.37523893351503756,0.128814357845992,0.4955001982356712,0.3885971577167074,0.1159026440476211,1,1,2,1,4,0,1
313,231,249,-82,-64,0.4442570049288188,0.448665165805631,0.10707782926555004,0.5108413545871531,0.36558800063550534,0.12357064477734173,0,1,2,1,1,1,0
293,210,236,-83,-57,0.3369888076843219,0.5394538392054253,0.12355735311025304,0.4373092031506147,0.4388699586839189,0.1238208381654664,0,1,1,1,1,1,0
475,350,496,-125,21,0.4019288122600275,0.4607542566969105,0.1373169310430621,0.5139352877849431,0.35988759920371477,0.12617711301134216,1,1,1,1,4,0,0
383,269,305,-114,-78,0.42033031386949943,0.45520491467293395,0.12446477145756643,0.48236237733092235,0.40843281992628044,0.1092048027427973,1,1,1,2,4,1,0
255,135,225,-120,-30,0.5219697520850455,0.3518738535567377,0.12615639435821663,0.5411114317230071,0.33946565465523515,0.11942291362175773,0,1,1,1,1,1,0
359,294,318,-65,-41,0.5046185379764574,0.38497618019578195,0.1104052818277609,0.4447960869387069,0.44200887108444425,0.11319504197684871,1,1,1,1,4,1,0
149,49,65,-100,-84,0.5012649267958298,0.37139975064719655,0.12733532255697363,0.4773565075346626,0.4042114880827553,0.11843200438258206,0,1,1,1,1,1,0
94,119,216,25,122,0.4837025562300108,0.40022832587212925,0.11606911789786006,0.46658451386100264,0.4213200617719523,0.11209542436704505,1,1,2,1,4,0,1
280,212,233,-68,-47,0.3958319382848223,0.48869268155345696,0.11547538016172067,0.46128240032322665,0.4220245379629497,0.11669306171382358,0,1,3,1,1,1,0
251,114,129,-137,-122,0.49847227213159767,0.3845774787802482,0.11695024908815409,0.469264156951211,0.4077647301064323,0.12297111294235678,1,1,1,1,4,1,0
350,250,289,-100,-61,0.38635498906023724,0.4942416652806461,0.11940334565911664,0.38262955220002426,0.5050377454837587,0.11233270231621675,0,1,1,1,1,1,0
379,326,363,-53,-16,0.3389634858657115,0.555855337520217,0.10518117661407153,0.4394249021783548,0.449640016804967,0.11093508101667832,0,1,1,2,1,1,0
253,269,331,16,78,0.5797241922124999,0.32430731659340467,0.09596849119409512,0.47257378431779995,0.4160447376853732,0.11138147799682681,1,1,1,1,4,0,1
362,282,314,-80,-48,0.4281585096820564,0.46197970512669934,0.10986178519124407,0.5222731321530043,0.35925494489791343,0.1184719229490822,0,1,1,1,1,1,0
420,146,335,-274,-85,0.29584906739853667,0.5777298410446263,0.1264210915568371,0.366548426644127,0.5244758873635333,0.10897568599233966,1,1,1,1,4,1,0
408,201,351,-207,-57,0.36396939618082463,0.5010474755165606,0.13498312830261452,0.37743144390479394,0.5116033969820974,0.11096515911310885,1,1,1,2,4,1,0
374,161,291,-213,-83,0.5228280208305003,0.3483415077071946,0.12883047146230509,0.5394528350839891,0.3425143187577886,0.11803284615822207,0,1,2,1,1,1,0
105,13,42,-92,-63,0.5046185379764574,0.38497618019578195,0.1104052818277609,0.4447960869387069,0.44200887108444425,0.11319504197684871,1,1,1,1,4,1,0
263,160,217,-103,-46,0.37558522598054817,0.49680627713642,0.12760849688303175,0.5348326891563202,0.3467051709107426,0.11846213993293733,0,1,3,1,1,1,0
462,153,172,-309,-290,0.43489615170452284,0.43252516413298897,0.13257868416248805,0.5416104382269163,0.3424885564051334,0.11590100536795017,0,1,1,1,1,1,0
393,354,377,-39,-16,0.2903779525763836,0.5944936112366402,0.11512843618697619,0.45364006356291153,0.43323515117956274,0.1131247852575259,0,1,1,1,1,1,0
390,314,416,-76,26,0.39394935024146815,0.48458962968586566,0.1214610200726662,0.3540163148377064,0.5342094165261788,0.11177426863611514,1,1,3,1,4,0,0
223,113,208,-110,-15,0.5032691888603961,0.38692304531532196,0.10980776582428223,0.4502417429799009,0.438096913970475,0.11166134304962427,1,1,1,1,4,1,0
293,0,260,-293,-33,0.5046185379764574,0.38497618019578195,0.1104052818277609,0.4447960869387069,0.44200887108444425,0.11319504197684871,1,1,1,1,5,1,0
286,182,189,-104,-97,0.45528361480021157,0.4336235605574259,0.11109282464236261,0.4576300628003372,0.4313721217307219,0.11099781546894072,0,1,1,1,1,1,0
432,237,360,-195,-72,0.45797936794027155,0.44165256185027774,0.10036807020945078,0.4268803377724801,0.4639154944827067,0.10920416774481315,1,1,1,1,4,1,0
388,181,217,-207,-171,0.3774643681802339,0.517544860582209,0.1049907712375565,0.3768615321093881,0.5119203172634083,0.11121815062720329,0,1,2,2,1,1,0
386,317,346,-69,-40,0.47774063474683093,0.4093327069971685,0.11292665825600058,0.4229810809694318,0.464604158309842,0.1124147607207263,1,1,1,1,4,1,0
235,98,120,-137,-115,0.49563308092964886,0.39992240797144396,0.10444451109890711,0.41966400695525446,0.46812801593407366,0.11220797711067168,1,1,2,1,4,1,0
443,296,362,-147,-81,0.46889433614149106,0.41811948297609547,0.11298618088241338,0.3654432323245522,0.5229793138141702,0.11157745386127722,1,1,1,3,4,1,0
250,194,213,-56,-37,0.36156247325076396,0.5264590653867024,0.11197846136253334,0.40567785926741773,0.48066617186850946,0.11365596886407249,1,1,1,2,4,1,0
170,192,228,22,58,0.32042563866805635,0.5336580614226907,0.14591629990925312,0.4484547381787099,0.4376668142194539,0.1138784476018361,1,1,1,1,4,0,1
252,162,233,-90,-19,0.5460995950058847,0.3498645997942801,0.1040358051998353,0.5402121148127857,0.3419003126883703,0.11788757249884413,0,1,1,1,1,1,0
338,194,214,-144,-124,0.4900340936947068,0.40454937531735036,0.10541653098794293,0.49771558980180264,0.38272308392663007,0.1195613262715672,0,1,1,2,1,1,0
396,244,293,-152,-103,0.3926057011333919,0.5009624905732654,0.10643180829334246,0.3621989919829809,0.5264786650821623,0.11132234293485632,0,1,1,1,1,1,0
281,223,239,-58,-42,0.4577684238315799,0.42055361580878653,0.12167796035963405,0.4193457656893399,0.4690107025213706,0.11164353178928924,1,1,1,1,4,1,0
440,367,387,-73,-53,0.3934690426524693,0.4285425059039194,0.17798845144361125,0.3668294881621922,0.5217646850793597,0.11140582675844801,1,1,1,2,4,1,0
366,237,324,-129,-42,0.4116650426423796,0.46802986336298197,0.12030509399463879,0.478499017889795,0.4031938495803335,0.11830713252987173,1,1,1,2,4,1,0
285,171,233,-114,-52,0.5092951925268295,0.3752387195392425,0.11546608793392799,0.4407043707478493,0.4478061878439701,0.1114894414081806,1,1,1,4,4,1,0
256,183,246,-73,-10,0.3634795763805298,0.5130674373254214,0.12345298629404892,0.4297406499131386,0.4606447317345132,0.10961461835234813,1,1,2,1,4,1,0
75,0,34,-75,-41,0.5046185379764574,0.38497618019578195,0.1104052818277609,0.4447960869387069,0.44200887108444425,0.11319504197684871,0,1,1,2,1,1,0
303,0,235,-303,-68,0.5046185379764574,0.38497618019578195,0.1104052818277609,0.4447960869387069,0.44200887108444425,0.11319504197684871,1,1,1,1,4,1,0
316,254,262,-62,-54,0.4711320886495568,0.4085361242143842,0.12033178713605881,0.478361957981356,0.3996513529279029,0.12198668909074134,0,1,1,1,1,1,0
511,190,254,-321,-257,0.44772973693296764,0.4165175410656338,0.13575272200139846,0.5016403347730709,0.37443501412286945,0.12392465110405955,0,1,1,1,1,1,0
472,432,491,-40,19,0.33012952078144214,0.5434148918831856,0.12645558733537204,0.2918820442228766,0.599363069533309,0.10875488624381417,1,1,2,2,4,0,0
483,419,446,-64,-37,0.35522249395248073,0.5089472070065392,0.13583029904098032,0.490976674860202,0.3859411032055986,0.12308222193419971,1,1,1,4,4,1,0
336,284,304,-52,-32,0.3276661920315658,0.5450515416343614,0.12728226633407277,0.4045324948914195,0.48384538731552473,0.11162211779305571,0,1,2,3,1,1,0
261,189,318,-72,57,0.48902493692629795,0.38055200538186656,0.1304230576918354,0.41016171736600104,0.4776616635667069,0.11217661906729211,1,1,1,3,4,0,0
324,192,256,-132,-68,0.45092838679624353,0.425574013169422,0.12349760003433469,0.46335667934714525,0.42420497634389404,0.11243834430896082,1,1,1,1,4,1,0
262,210,237,-52,-25,0.42406608555744496,0.4547032998579389,0.12123061458461612,0.44440142962209284,0.42864712059569626,0.12695144978221082,1,1,1,1,4,1,0
409,333,367,-76,-42,0.41575516894164594,0.45036373562411136,0.13388109543424273,0.4396450739042845,0.4355238480306506,0.12483107806506513,0,1,1,1,1,1,0
342,302,308,-40,-34,0.3233347309618345,0.5418915194117517,0.13477374962641375,0.39415722083141214,0.4962981206028145,0.10954465856577349,0,1,2,2,1,1,0
348,208,301,-140,-47,0.5063460319857694,0.38820688611644677,0.10544708189778389,0.5471607036366525,0.33147894615483736,0.12136035020851026,0,1,2,1,1,1,0
449,399,440,-50,-9,0.4365514069228886,0.45392481626448883,0.10952377681262263,0.41714066096324104,0.47223411279127203,0.1106252262454867,1,1,1,2,4,1,0
351,209,279,-142,-72,0.5421623445025453,0.3588079381240299,0.0990297173734248,0.4279485300511555,0.4614008475136469,0.11065062243519755,1,1,1,1,4,1,0
393,349,375,-44,-18,0.39993670100153234,0.46751890032100946,0.13254439867745837,0.4067258925253885,0.48097536036347294,0.11229874711113873,1,1,2,2,4,1,0
307,126,266,-181,-41,0.5189051916800027,0.38068532996803495,0.10040947835196244,0.5378891321127685,0.3469652435215783,0.11514562436565337,0,1,1,1,1,1,0
280,221,238,-59,-42,0.5083862957571028,0.3956982857231687,0.0959154185197283,0.5092509928936395,0.37769182260695155,0.11305718449940906,0,1,3,2,1,1,0
358,191,233,-167,-125,0.561321731479276,0.3486871725288145,0.08999109599190946,0.5171796064545312,0.36922125544603196,0.1135991380994369,1,1,2,1,4,1,0
372,260,297,-112,-75,0.30445872277676306,0.5728030498757597,0.12273822734747747,0.5105647248239658,0.38008390150574417,0.10935137367028987,0,1,3,1,1,1,0
466,326,334,-140,-132,0.3942889698755371,0.4853746704211648,0.12033635970329815,0.42360985463276546,0.4676030853325905,0.10878706003464421,1,1,1,1,4,1,0
291,249,269,-42,-22,0.4568722614111378,0.42453564638515356,0.11859209220370871,0.4213016649813648,0.46836055203444377,0.1103377829841913,1,1,4,2,4,1,0
280,43,141,-237,-139,0.40821042323750595,0.4714406367482399,0.12034894001425411,0.42243792964394555,0.46788582859572486,0.10967624176032963,1,1,1,1,4,1,0
330,206,300,-124,-30,0.3380434286569355,0.5333437108941067,0.12861286044895756,0.43334843668240886,0.457642545977176,0.1090090173404152,1,1,1,3,4,1,0
364,282,318,-82,-46,0.4221955313616782,0.45651812965660155,0.12128633898172042,0.39750599797995745,0.4929119374246923,0.10958206459535048,0,1,1,1,1,1,0
406,289,357,-117,-49,0.40444722210988954,0.47559470093555967,0.11995807695455088,0.35772187960668694,0.532361575951882,0.10991654444143084,0,1,2,1,1,1,0
320,161,250,-159,-70,0.38122900820715494,0.49261117195754883,0.1261598198352961,0.5246875759211321,0.3610295004615928,0.1142829236172748,1,1,1,1,4,1,0
239,193,219,-46,-20,0.4203041225470513,0.45619016680430624,0.12350571064864224,0.4493889306821984,0.4348672451462982,0.11574382417150349,1,1,1,1,4,1,0
457,367,425,-90,-32,0.4537295199217128,0.4342622445843595,0.11200823549392748,0.44513358237005274,0.4426205582130324,0.11224585941691462,0,1,2,3,1,1,0
305,265,371,-40,66,0.49249127462794584,0.404493692560777,0.10301503281127714,0.5235309762768656,0.3585723128768859,0.11789671084624857,0,1,1,1,1,0,0
312,143,326,-169,14,0.38405600624913244,0.500229569678854,0.1157144240720136,0.43633031035099834,0.4527714091705834,0.11089828047841842,1,1,1,1,4,0,0
363,264,311,-99,-52,0.4597546527698247,0.42557866192567934,0.11466668530449609,0.402452513903311,0.48420956191798664,0.11333792417870246,0,1,1,2,1,1,0
473,419,446,-54,-27,0.40899852351925203,0.46312533313714493,0.12787614334360278,0.5385229658847492,0.34258597877864533,0.11889105533660539,1,1,1,2,4,1,0
457,258,281,-199,-176,0.49405586575869836,0.4101804838346383,0.09576365040666332,0.3350440380018551,0.5559313128446959,0.10902464915344907,1,1,1,1,4,1,0
349,237,324,-112,-25,0.4224245953862108,0.46898521787104297,0.1085901867427462,0.5350586496672927,0.34342124310205513,0.12152010723065224,1,1,1,1,4,1,0
479,400,432,-79,-47,0.5562045870654614,0.32075204386891654,0.12304336906562205,0.5383904462723975,0.34287768781284145,0.11873186591476095,0,1,1,1,1,1,0
338,263,404,-75,66,0.3751935115720971,0.5183148042752688,0.10649168415263378,0.47940119838053435,0.40828021253060437,0.11231858908886111,1,1,1,1,4,0,0
328,364,412,36,84,0.5101155672990242,0.385387356441102,0.10449707625987385,0.5068792226916994,0.38180802346999004,0.11131275383831078,0,1,1,1,1,0,1
305,255,274,-50,-31,0.4507727579319036,0.4319870777846023,0.11724016428349392,0.49399534800414785,0.39237659310285006,0.11362805889300229,0,1,2,3,1,1,0
275,217,260,-58,-15,0.40992307994146554,0.4750962508810258,0.11498066917750878,0.45422436594245574,0.43255031370059843,0.11322532035694559,1,1,1,1,4,1,0
