Pronoun-offset,A-offset,B-offset,offsetPronoun-A,offsetPronoun-B,pre_predict-A,pre_predict-B,pre_predict-N,tar_predict-A,tar_predict-B,tar_predict-N,PronounType,GenderBin,CountNounA,CountNounB,Pronoun_binary,IsFinalPro,IsInitialPro
274,191,207,-83,-67,0.44828856616231616,0.43737943288892855,0.11433200094875519,0.48722560989034974,0.38681379300085744,0.12596059710879304,1,1,1,2,4,1,0
284,228,251,-56,-33,0.48405882009598095,0.3939310674788687,0.12201011242515002,0.4996837258822053,0.3960634985692269,0.10425277554856792,1,0,1,1,2,1,0
265,173,246,-92,-19,0.4438852926348604,0.43977968434889275,0.11633502301624694,0.45356507356470993,0.4277033168142976,0.11873160962099252,1,0,1,3,2,1,0
321,174,336,-147,15,0.4678691457539979,0.4182610777325801,0.11386977651342205,0.4531738426209542,0.43014450697902745,0.11668165040001838,1,0,1,1,2,0,0
437,219,294,-218,-143,0.533419360785841,0.34647056708874935,0.12011007212540985,0.5387487454214983,0.37071837146431685,0.09053288311418481,0,1,2,1,1,1,0
411,236,347,-175,-64,0.43756690169774276,0.44495499116742304,0.1174781071348344,0.361751221863673,0.5077472835414352,0.1305014945948916,0,1,2,2,1,1,0
273,152,253,-121,-20,0.42966306921218966,0.4565043821741496,0.11383254861366063,0.4979554027882489,0.378011777787717,0.12403281942403414,1,0,1,1,2,1,0
337,173,377,-164,40,0.4551253341557976,0.43016922793744605,0.11470543790675633,0.37806696269937945,0.49473999790574896,0.12719303939487184,1,0,1,1,2,0,0
246,255,267,9,21,0.4893601662042103,0.392662403954022,0.11797742984176773,0.43781197730868976,0.4455970998425362,0.11659092284877416,1,1,1,1,4,0,1
329,196,226,-133,-103,0.4862364316166238,0.39992548647684506,0.11383808190653097,0.5110731179445042,0.36913979327385704,0.11978708878163903,0,1,1,1,1,1,0
300,168,212,-132,-88,0.4447960869387069,0.44200887108444425,0.11319504197684871,0.5046185379764574,0.38497618019578195,0.1104052818277609,1,0,1,1,2,1,0
304,217,285,-87,-19,0.4759362254657015,0.40830026151593946,0.11576351301835892,0.39309249881703984,0.4365753064340864,0.17033219474887382,0,1,3,1,1,1,0
293,247,273,-46,-20,0.4983192663865554,0.3892467414183812,0.11243399219506342,0.4698249225170487,0.42373252795056787,0.10644254953238365,1,1,2,1,4,1,0
340,275,297,-65,-43,0.335204363323634,0.5535404369003484,0.11125519977601736,0.5292781959124923,0.35393460415114436,0.1167871999363631,1,0,1,1,2,1,0
250,219,235,-31,-15,0.37001791709350607,0.5202649415331286,0.10971714137336505,0.3746935119587076,0.5079243984504724,0.11738208959082001,1,1,3,1,4,1,0
295,192,219,-103,-76,0.4998291437009263,0.38559470312248906,0.11457615317658454,0.4592640348236641,0.43518540361038927,0.10555056156594649,0,1,1,2,1,1,0
384,334,365,-50,-19,0.41954148598429264,0.46420805216699823,0.11625046184870882,0.3511082212828906,0.526457587269726,0.12243419144738323,1,0,3,1,3,1,0
330,181,235,-149,-95,0.4469484485900305,0.4397874083540887,0.1132641430558809,0.38986702571506443,0.502653672160977,0.10747930212395856,1,0,1,1,2,1,0
335,281,296,-54,-39,0.46601424497341626,0.4194476332273792,0.11453812179920464,0.47143436568956004,0.41356358283897227,0.11500205147146766,1,0,2,1,3,1,0
476,330,381,-146,-95,0.4189311271094742,0.46608703689859665,0.11498183599192896,0.292525455962782,0.5808675076279249,0.1266070364092929,1,0,2,4,2,1,0
234,113,150,-121,-84,0.42660891399255824,0.4568730845808778,0.11651800142656377,0.44954400362414887,0.42309229256386915,0.12736370381198203,0,0,1,2,0,1,0
304,317,338,13,34,0.47042477422517337,0.4197053760066607,0.10986984976816624,0.5364911667548741,0.346128329728695,0.11738050351643083,1,0,2,1,2,0,1
430,296,386,-134,-44,0.4067049735364065,0.48298914503262413,0.11030588143096946,0.461450343115802,0.4186812216426319,0.11986843524156639,1,0,3,1,2,1,0
447,273,301,-174,-146,0.4072207785563388,0.4838037662774558,0.10897545516620534,0.40228294823159017,0.4710785932217821,0.126638458546628,1,1,1,3,4,1,0
329,210,266,-119,-63,0.4362818009304169,0.4495884336952718,0.11412976537431123,0.36213102421711324,0.515431412732302,0.12243756305058441,1,1,1,1,4,1,0
299,92,266,-207,-33,0.4440684264739493,0.4424440589967253,0.11348751452932532,0.4696384444406702,0.4160274145497599,0.11433414100956978,1,0,1,1,2,1,0
280,238,263,-42,-17,0.42155269559195246,0.46624900868036834,0.11219829572767896,0.33521976818507804,0.525519028349723,0.1392612034651988,1,1,1,4,4,1,0
194,204,223,10,29,0.48769888194358,0.3941454743484989,0.11815564370792121,0.4499056818033673,0.4193303451383269,0.130763973058306,1,0,2,1,2,0,1
250,153,189,-97,-61,0.41724293179941724,0.4707297635342104,0.11202730466637251,0.40755036209140816,0.4661682812945716,0.1262813566140203,1,0,1,1,3,1,0
294,241,258,-53,-36,0.45158400230352086,0.43456786876232983,0.11384812893414938,0.4495145657126036,0.44252616739950196,0.10795926688789445,1,0,2,1,2,1,0
375,248,283,-127,-92,0.38241608419668954,0.5084910193739256,0.109092896429385,0.5101575239260292,0.3856447127379669,0.10419776333600404,0,0,1,2,0,1,0
440,229,301,-211,-139,0.4128519323320565,0.47371207434093443,0.11343599332700888,0.4164128315537427,0.4575996787752577,0.12598748967099957,1,1,1,1,4,1,0
466,345,383,-121,-83,0.4186416416189243,0.47249490001035604,0.10886345837071999,0.3921282727528964,0.5055330747022377,0.10233865254486571,0,1,1,4,1,1,0
375,238,306,-137,-69,0.4665678457465737,0.41824849402612485,0.11518366022730141,0.4215770415780269,0.45464378853008447,0.12377916989188896,0,1,1,2,1,1,0
346,206,325,-140,-21,0.42274243812621604,0.46658630517691335,0.1106712566968707,0.31079708365612196,0.5449276235364849,0.144275292807393,0,0,1,2,0,1,0
477,340,460,-137,-17,0.47279050724750604,0.40889884434226526,0.11831064841022876,0.4613982184019715,0.4277540598976261,0.11084772170040211,1,0,3,1,2,1,0
292,227,237,-65,-55,0.4000762538128154,0.482712668848342,0.11721107733884291,0.379239349357956,0.4933608891298954,0.12739976151214882,0,0,1,1,0,1,0
315,246,301,-69,-14,0.42165842318595886,0.462408607812451,0.11593296900159002,0.4611099679033455,0.4180937704072595,0.12079626168939493,1,1,2,1,4,1,0
306,209,295,-97,-11,0.444638653480208,0.4408088698731643,0.1145524766466276,0.3136883402211165,0.5914838338599623,0.09482782591892126,0,0,2,1,0,1,0
283,161,264,-122,-19,0.4820626421536107,0.4026635157473073,0.1152738420990819,0.3459380026472923,0.5464105056328161,0.10765149171989118,0,0,1,1,0,1,0
285,194,218,-91,-67,0.4946629113571393,0.3951891122216787,0.11014797642118207,0.4258619591792415,0.4514946050283917,0.12264343579236674,0,0,1,3,0,1,0
491,312,345,-179,-146,0.4691198272605788,0.4075186129325818,0.1233615598068397,0.4581764945191378,0.38809802471359434,0.15372548076726797,0,0,1,1,0,1,0
337,348,355,11,18,0.411390975532716,0.4766631085034574,0.11194591596382658,0.4431863541543705,0.4287493277425939,0.12806431810303562,1,1,2,2,4,0,1
450,361,396,-89,-54,0.398763760537352,0.487150532195891,0.1140857072667571,0.18795989171433963,0.6612949395726129,0.15074516871304733,0,1,1,1,1,1,0
312,245,261,-67,-51,0.5113288355150535,0.3767511114895139,0.11192005299543248,0.4961425421927464,0.4152655601490871,0.0885918976581664,0,1,2,1,1,1,0
301,335,441,34,140,0.4429049864686821,0.44172893720393,0.11536607632738817,0.410542639527744,0.47305840214400363,0.11639895832825263,1,1,1,1,4,0,1
270,154,260,-116,-10,0.44931764594281415,0.4372887467282929,0.11339360732889317,0.4730726686489413,0.4277185658137317,0.09920876553732694,0,1,1,1,1,1,0
320,259,284,-61,-36,0.4447960869387069,0.44200887108444425,0.11319504197684871,0.5046185379764574,0.38497618019578195,0.1104052818277609,1,1,1,1,4,1,0
239,138,199,-101,-40,0.5012596361625742,0.38220218599694034,0.11653817784048555,0.45922346734449565,0.41831078287546,0.1224657497800445,0,1,1,1,1,1,0
361,51,80,-310,-281,0.47804586951439043,0.40606343609342377,0.11589069439218613,0.580619316874293,0.32449158269612316,0.09488910042958386,1,0,1,1,2,1,0
269,245,255,-24,-14,0.4519336562260128,0.43393802771150575,0.11412831606248146,0.47781169019352326,0.4026866376879221,0.11950167211855453,1,0,1,2,2,1,0
284,247,270,-37,-14,0.4483806255103791,0.4391173654336757,0.11250200905594517,0.33102519208850156,0.5681444559308497,0.1008303519806486,1,1,1,3,4,1,0
166,189,221,23,55,0.44406827368638596,0.441538962904849,0.11439276340876468,0.4253218335504857,0.4644253013810955,0.11025286506841893,1,1,1,2,4,0,1
392,104,280,-288,-112,0.4447960869387069,0.44200887108444425,0.11319504197684871,0.5046185379764574,0.38497618019578195,0.1104052818277609,1,0,1,1,2,1,0
347,188,243,-159,-104,0.5019114463283574,0.3843456105559834,0.11374294311565931,0.42246744719250856,0.4609097895518386,0.11662276325565277,1,0,1,2,2,1,0
267,104,194,-163,-73,0.4517891279224943,0.4337581818050109,0.11445269027249494,0.4908129388197602,0.39564338750309064,0.11354367367714908,1,0,1,1,2,1,0
287,183,331,-104,44,0.49976046474305896,0.385170204303048,0.11506933095389332,0.3920743204241949,0.4957100295349849,0.11221565004082037,1,1,1,1,4,0,0
313,159,195,-154,-118,0.4325978054557947,0.4562124686705556,0.11118972587364966,0.4252970132220479,0.4402187770288556,0.1344842097490965,1,1,3,1,4,1,0
273,194,248,-79,-25,0.3996538600734431,0.48809272074591986,0.11225341918063697,0.4157533335862504,0.4855125475834319,0.09873411883031745,0,0,2,4,0,1,0
353,168,405,-185,52,0.40458723731750934,0.47866494658911074,0.11674781609337977,0.4099401019690123,0.4569961993304705,0.13306369870051715,0,0,2,1,0,0,0
389,305,365,-84,-24,0.45986047967278537,0.427940717501177,0.11219880282603727,0.43178150647578395,0.4480421734167994,0.12017632010741679,0,0,1,1,0,1,0
354,312,341,-42,-13,0.48831885981404133,0.39600013823538677,0.11568100195057208,0.5388028299107042,0.33159859166210065,0.12959857842719522,0,1,1,1,1,1,0
443,384,430,-59,-13,0.44093025772107797,0.44224928139274655,0.11682046088617533,0.4804989598522233,0.40046777113626475,0.11903326901151214,0,0,1,3,0,1,0
339,176,234,-163,-105,0.5227702340527316,0.358206904368477,0.11902286157879093,0.4523841436010296,0.4116459106651129,0.1359699457338575,1,1,1,2,4,1,0
246,152,180,-94,-66,0.4447960869387069,0.44200887108444425,0.11319504197684871,0.5046185379764574,0.38497618019578195,0.1104052818277609,0,1,1,2,1,1,0
276,129,248,-147,-28,0.4775725137059471,0.40671925563744754,0.11570823065660531,0.46384776688217627,0.40714094257987243,0.1290112905379514,1,0,1,1,2,1,0
269,187,234,-82,-35,0.45360734419858373,0.4306368758167845,0.11575577998463157,0.4062246886593637,0.4567447078661925,0.13703060347444407,1,1,1,4,4,1,0
293,304,394,11,101,0.3932538587420961,0.4935172408536842,0.11322890040421986,0.3155956174335974,0.5531136600981656,0.13129072246823753,1,0,4,1,2,0,1
300,212,267,-88,-33,0.42396288356528483,0.4621434045346373,0.11389371190007803,0.4218812060096732,0.4552593610375215,0.12285943295280512,1,1,1,1,4,1,0
313,181,215,-132,-98,0.43054646938365704,0.4585660104640442,0.1108875201522987,0.30858291254747844,0.5808791832536633,0.1105379041988583,0,1,1,1,1,1,0
306,225,268,-81,-38,0.46127956308211115,0.4273316535804518,0.11138878333743711,0.46367296916369066,0.43593108085028454,0.10039594998602457,1,0,2,3,2,1,0
315,29,110,-286,-205,0.4506384957086483,0.434807746918255,0.1145537573730967,0.45137306250029824,0.4140517044366611,0.1345752330630404,0,1,1,1,1,1,0
377,279,318,-98,-59,0.4849651003253027,0.39949440064573777,0.11554049902895962,0.5223807668655259,0.36698494045650604,0.110634292677968,1,0,3,7,2,1,0
275,302,449,27,174,0.5106178758164592,0.36914782054975787,0.12023430363378335,0.5253719784216695,0.36710740440606043,0.10752061717227028,1,0,1,1,2,0,1
363,290,330,-73,-33,0.4291846056421309,0.45832838650899366,0.1124870078488752,0.3480654493046431,0.5183893517910325,0.13354519890432423,1,0,3,1,2,1,0
257,139,242,-118,-15,0.4464082311417641,0.43831243471148457,0.11527933414675118,0.3557000373339528,0.5223626377254793,0.12193732494056773,0,0,1,1,0,1,0
359,228,261,-131,-98,0.43526838049972955,0.4527157106513971,0.1120159088488732,0.46388828338493393,0.4232925874677346,0.11281912914733126,1,0,1,1,3,1,0
355,251,321,-104,-34,0.4313353054542455,0.45370805961181043,0.11495663493394401,0.4875991421881559,0.3885552257439647,0.12384563206787923,1,1,1,1,4,1,0
412,296,351,-116,-61,0.4115451565393112,0.47458429580253436,0.11387054765815435,0.4146138579458699,0.4738276039802521,0.11155853807387779,1,0,2,1,2,1,0
312,341,354,29,42,0.4575961877151163,0.4291205138584021,0.11328329842648147,0.45882280083111665,0.4306286605332045,0.11054853863567886,1,0,3,3,2,0,1
252,169,538,-83,286,0.4999668266289796,0.38224680543274736,0.11778636793827282,0.5347097099955641,0.3628570213718495,0.1024332686325866,1,1,1,1,4,0,0
339,285,299,-54,-40,0.3815876436010943,0.5069910764054545,0.11142127999345118,0.33892291217466075,0.5159679161580574,0.14510917166728193,1,0,2,1,2,1,0
276,232,258,-44,-18,0.4477999404521585,0.4364362525763013,0.11576380697154003,0.45634590164395955,0.43871163149855796,0.10494246685748214,0,1,2,1,1,1,0
316,220,270,-96,-46,0.45454583028277556,0.42933533157256165,0.11611883814466281,0.5059367110713674,0.36445893490139847,0.1296043540272342,1,0,1,1,2,1,0
278,240,267,-38,-11,0.4712798878576589,0.414534230927746,0.1141858812145951,0.42593827554449576,0.4665979454681164,0.10746377898738795,1,1,2,1,4,1,0
385,405,439,20,54,0.4433283179716464,0.4431274249455027,0.11354425708285099,0.4431216498467486,0.44563637059993594,0.11124197955331554,1,0,1,1,2,0,1
302,185,192,-117,-110,0.40682102076836657,0.47881827489900586,0.11436070433262775,0.46097936272912515,0.424064395917989,0.11495624135288583,0,0,1,2,0,1,0
261,231,253,-30,-8,0.36850750280924915,0.5235284176643646,0.10796407952638622,0.3482269093341648,0.5426471038422294,0.10912598682360569,0,0,2,4,0,1,0
283,296,323,13,40,0.4447960869387069,0.44200887108444425,0.11319504197684871,0.5046185379764574,0.38497618019578195,0.1104052818277609,1,0,1,1,2,0,1
360,313,337,-47,-23,0.47724927155000596,0.4094578948174562,0.11329283363253762,0.39499526565475523,0.4864952766868025,0.11850945765844229,1,1,2,3,4,1,0
329,179,248,-150,-81,0.43272555283485536,0.45434000441812517,0.11293444274701969,0.5082277121284541,0.3807455136199744,0.11102677425157124,1,0,1,1,2,1,0
598,511,554,-87,-44,0.4412461523052445,0.44943581777383873,0.10931802992091674,0.49040088856657255,0.4069650293522921,0.1026340820811352,0,1,1,1,1,1,0
323,117,177,-206,-146,0.4248904571354078,0.4573160065001499,0.11779353636444201,0.3748339456437201,0.5184070538033393,0.10675900055294099,1,1,1,1,4,1,0
367,174,349,-193,-18,0.5291977628039327,0.3537339973960529,0.1170682398000141,0.447496923590221,0.4089003821532783,0.1436026942565006,0,1,2,1,1,1,0
379,364,518,-15,139,0.47402593585560837,0.4128659206131104,0.11310814353128112,0.38585454128522917,0.4958222999682902,0.11832315874648075,1,0,3,3,2,0,0
300,165,268,-135,-32,0.40981337239665666,0.47937682186251723,0.11080980574082637,0.4929083720605834,0.3909467665686653,0.1161448613707514,0,0,1,3,0,1,0
357,403,448,46,91,0.4063222071323209,0.4795926948473283,0.11408509802035066,0.4254790195003659,0.4632968376483453,0.11122414285128904,1,0,1,3,2,0,1
428,240,290,-188,-138,0.4542693457586454,0.4294890503039707,0.11624160393738382,0.36042583763839825,0.513868094170728,0.12570606819087374,0,0,1,1,0,1,0
292,257,277,-35,-15,0.4834665315528602,0.3984674709552979,0.11806599749184181,0.45252110820978175,0.4465582422107948,0.10092064957942352,1,0,2,2,3,1,0
360,254,336,-106,-24,0.42547134857749497,0.4555631729487607,0.11896547847374421,0.41541843266950057,0.4415810963044075,0.1430004710260918,0,0,1,1,0,1,0
459,214,381,-245,-78,0.4572045947497198,0.4308240649403058,0.11197134030997438,0.47569475890854407,0.40433910389972144,0.11996613719173438,0,1,1,1,1,1,0
347,0,141,-347,-206,0.46463154025495407,0.42043297238161637,0.11493548736342951,0.4552012168622035,0.4352997424120618,0.1094990407257345,1,0,1,1,2,1,0
263,224,300,-39,37,0.46987012712512494,0.41274567257773315,0.11738420029714199,0.39732534886379656,0.47466888336424945,0.12800576777195405,1,0,1,2,2,0,0
240,249,319,9,79,0.47311581571771677,0.41204563990740645,0.11483854437487681,0.42973469682788784,0.43511260159566095,0.13515270157645118,1,0,1,1,2,0,1
254,183,226,-71,-28,0.42684485275875583,0.46212280663770083,0.11103234060354329,0.4618097649563292,0.4258608934689716,0.11232934157469911,1,1,1,1,4,1,0
305,215,236,-90,-69,0.435360371721178,0.45383312238002527,0.11080650589879701,0.46122064567259585,0.4204778265306163,0.1183015277967878,0,1,2,2,1,1,0
241,158,209,-83,-32,0.4717682779704301,0.4179007923401741,0.11033092968939602,0.505704962601241,0.37551255535692557,0.11878248204183325,1,1,4,1,4,1,0
263,196,239,-67,-24,0.4642137836074841,0.4180948952004354,0.11769132119208028,0.4693312128152981,0.4089394996053151,0.1217292875793866,1,1,2,2,4,1,0
288,217,249,-71,-39,0.44329945265805787,0.443881642299896,0.11281890504204586,0.4988064725351561,0.3862756163893044,0.11491791107553963,0,1,2,1,1,1,0
291,172,231,-119,-60,0.406946621622473,0.4805157899844669,0.11253758839305983,0.4317541391666674,0.453266693696853,0.11497916713647964,1,0,1,1,2,1,0
79,0,36,-79,-43,0.4393694771675084,0.4479334482577298,0.11269707457476173,0.4606359825506559,0.42310655202364644,0.1162574654256977,0,1,1,1,1,1,0
94,0,239,-94,145,0.43852365786326347,0.4465455614023875,0.1149307807343489,0.42330735665597746,0.45003553247317796,0.12665711087084466,1,0,1,1,2,0,0
280,184,205,-96,-75,0.46663778179705956,0.419465652535294,0.11389656566764632,0.49996032873335544,0.3935365519179952,0.1065031193486493,1,1,2,3,4,1,0
335,264,359,-71,24,0.42896017615345644,0.460190264823534,0.11084955902300968,0.45098769965611646,0.42968029883277936,0.11933200151110382,1,0,1,2,2,0,0
334,250,264,-84,-70,0.42299232629741446,0.46293476554452073,0.11407290815806466,0.36231238211130967,0.5167186447125646,0.12096897317612562,1,1,2,1,4,1,0
341,290,302,-51,-39,0.4359768527471838,0.4485615278170847,0.11546161943573141,0.3799911803388723,0.4913161112426446,0.128692708418483,1,1,3,4,4,1,0
284,188,267,-96,-17,0.4398433830740924,0.44824097483638714,0.11191564208952064,0.5053062275465915,0.38453497885934207,0.11015879359406644,1,0,1,1,3,1,0
328,285,307,-43,-21,0.4403862685314523,0.44846266588226663,0.11115106558628121,0.5097906723175158,0.37998294963560164,0.11022637804688262,0,1,1,2,1,1,0
360,402,432,42,72,0.38510541854525393,0.5004259431048965,0.11446863834984947,0.3366336785374483,0.5643231394885067,0.09904318197404502,0,0,1,4,0,0,1
329,350,368,21,39,0.5043335179277116,0.38073554797050474,0.1149309341017836,0.45079480378792963,0.43990789488216936,0.10929730132990101,1,0,4,1,2,0,1
394,224,406,-170,12,0.4999339199491449,0.3820130791580631,0.11805300089279189,0.38752246580006194,0.5056993186595122,0.10677821554042567,1,0,1,1,2,0,0
357,406,467,49,110,0.4447960869387069,0.44200887108444425,0.11319504197684871,0.5046185379764574,0.38497618019578195,0.1104052818277609,1,0,1,1,2,0,1
457,435,442,-22,-15,0.4034759283237041,0.47965431081490234,0.11686976086139353,0.29229021172823727,0.5688412570674017,0.13886853120436116,0,1,2,2,1,1,0
383,320,369,-63,-14,0.43665782025806826,0.44805593891702056,0.11528624082491128,0.2693963661414489,0.5766823071253496,0.15392132673320139,0,0,4,2,0,1,0
300,192,255,-108,-45,0.4448655107951442,0.43870935591791105,0.11642513328694462,0.42023982066868765,0.46051967549293893,0.11924050383837319,0,0,1,1,0,1,0
446,324,349,-122,-97,0.46575970766373564,0.41454243517212036,0.11969785716414451,0.3803533134416495,0.48769427710670643,0.13195240945164405,1,0,1,2,2,1,0
406,219,305,-187,-101,0.46107825837112637,0.42348244512076894,0.11543929650810483,0.29424351150837746,0.5634602168248337,0.14229627166678863,1,0,1,3,2,1,0
249,185,201,-64,-48,0.475700127427968,0.4104075586978624,0.11389231387416981,0.36338381462680874,0.5271331835727052,0.109483001800486,1,0,2,1,2,1,0
261,129,251,-132,-10,0.4466370819456525,0.44056272550059655,0.11280019255375091,0.5147932936140588,0.3830992274986755,0.10210747888726582,1,1,1,1,4,1,0
285,216,234,-69,-51,0.44400547801956175,0.44441668883078644,0.11157783314965183,0.4900472082829351,0.4091812713788895,0.10077152033817544,0,0,1,1,0,1,0
363,259,322,-104,-41,0.49516145290826724,0.3847108887148562,0.12012765837687661,0.31759924125442374,0.5560206146275312,0.12638014411804505,0,0,1,2,0,1,0
230,242,266,12,36,0.3871482268178647,0.5000793704260647,0.11277240275607066,0.4653218264233174,0.42760985601252416,0.10706831756415848,1,0,1,3,2,0,1
274,186,237,-88,-37,0.47548285450568273,0.41286188901582443,0.11165525647849288,0.39185116527774366,0.4910330158119174,0.1171158189103389,0,0,2,1,0,1,0
287,196,250,-91,-37,0.577782525528648,0.3086959243742734,0.11352155009707861,0.4476678475976718,0.40054665447750093,0.1517854979248272,0,1,1,1,1,1,0
170,215,229,45,59,0.4814051753730217,0.40291054102457935,0.11568428360239895,0.531959646883513,0.3452586905994473,0.12278166251704004,0,0,1,2,0,0,1
323,354,449,31,126,0.4917329223031576,0.3953457235683915,0.11292135412845097,0.3958447973920296,0.510356104167845,0.09379909844012536,1,0,3,1,2,0,1
296,183,261,-113,-35,0.4469073668745478,0.43642947723556574,0.1166631558898864,0.4313132663412424,0.44431936497529506,0.12436736868346263,1,1,1,1,4,1,0
422,307,388,-115,-34,0.4666865370513575,0.4138518310179139,0.11946163193072859,0.29760534566080415,0.5778009544963157,0.12459369984288018,1,0,2,2,2,1,0
357,322,339,-35,-18,0.45051488165442094,0.4357972523979284,0.1136878659476506,0.33747042503605157,0.5571118228323781,0.10541775213157016,0,1,1,3,1,1,0
331,248,280,-83,-51,0.4701167204318013,0.4168302693753606,0.11305301019283827,0.27984894744088284,0.5680883714436171,0.1520626811155003,1,1,3,1,4,1,0
396,409,429,13,33,0.42956661438598126,0.455507848084818,0.11492553752920091,0.20682698453384335,0.6779829354513471,0.11519008001480924,0,1,4,4,1,0,1
315,342,366,27,51,0.42495105362574076,0.4649160612230103,0.11013288515124851,0.3443097202277612,0.5343680564984833,0.12132222327375536,1,1,4,1,4,0,1
140,9,128,-131,-12,0.46501875992271274,0.4252248230183036,0.10975641705898342,0.40429615853418127,0.47233386218033424,0.12336997928548415,0,1,1,6,1,1,0
335,268,290,-67,-45,0.3873901724807329,0.48829636152076555,0.12431346599850182,0.2436624585451058,0.608366335950779,0.1479712055041154,1,1,3,1,4,1,0
304,251,339,-53,35,0.3706857830261746,0.5169163385987826,0.11239787837504306,0.33080270543452306,0.5303580237424945,0.1388392708229828,0,0,3,1,0,0,0
430,501,526,71,96,0.4570979797662779,0.42989243116821035,0.11300958906551176,0.44606302164977074,0.42512082930718476,0.12881614904304467,1,1,3,1,4,0,1
394,298,359,-96,-35,0.4320697722855704,0.4552210354729156,0.1127091922415138,0.44197106014854737,0.4388774668001374,0.11915147305131527,1,0,1,2,3,1,0
271,225,262,-46,-9,0.45870199750442286,0.42542571233091275,0.11587229016466448,0.46102064465106257,0.4081349025348588,0.13084445281407853,0,1,1,5,1,1,0
418,318,401,-100,-17,0.44626675312616826,0.43993580322897474,0.11379744364485729,0.45958703559824793,0.41237009981161593,0.12804286459013617,0,0,1,3,0,1,0
285,24,247,-261,-38,0.4447960869387069,0.44200887108444425,0.11319504197684871,0.5046185379764574,0.38497618019578195,0.1104052818277609,1,0,1,1,2,1,0
421,206,276,-215,-145,0.5238548199645926,0.36392067951201584,0.11222450052339153,0.2630096589711982,0.6279808390421057,0.10900950198669625,1,0,2,1,2,1,0
268,158,246,-110,-22,0.47791875172529596,0.41301989167741515,0.10906135659728888,0.3938598235773446,0.48401064990841525,0.12212952651424014,1,1,1,2,4,1,0
333,379,491,46,158,0.457315195035016,0.4246433225823243,0.11804148238265962,0.41826005876520606,0.46109820908507876,0.12064173214971494,1,0,1,1,2,0,1
245,224,230,-21,-15,0.47418848778584277,0.410139369319078,0.11567214289507949,0.4667271062647974,0.40538211113166567,0.12789078260353667,1,1,2,3,4,1,0
271,143,152,-128,-119,0.40210927689849363,0.4840233965336082,0.11386732656789805,0.46852703850037236,0.4222012256792365,0.10927173582039125,1,1,4,1,4,1,0
282,316,395,34,113,0.4383509534394952,0.44784189361535226,0.11380715294515234,0.4259881708202685,0.4359554352581467,0.1380563939215847,0,0,1,1,0,0,1
508,497,524,-11,16,0.5536340340956777,0.3293859551070522,0.11698001079726997,0.2931551410224323,0.5538190378216483,0.15302582115591934,1,0,1,4,2,0,0
545,347,532,-198,-13,0.2776200379930768,0.6112992657661914,0.11108069624073152,0.38795249049180835,0.5087624221516622,0.10328508735652944,0,0,2,1,0,1,0
332,243,284,-89,-48,0.48974715721999884,0.39642879561569266,0.11382404716430877,0.39475824439324003,0.45458885758064327,0.15065289802611667,1,0,1,1,2,1,0
303,137,282,-166,-21,0.4758587544170469,0.4107066641342435,0.11343458144870944,0.38431049676902834,0.5074674533864414,0.1082220498445302,0,1,1,1,1,1,0
275,167,216,-108,-59,0.4700760987434572,0.4175718328000451,0.11235206845649776,0.3249352346065287,0.5534871133186876,0.12157765207478377,0,1,1,1,1,1,0
182,220,266,38,84,0.5095815982010198,0.3774762679225007,0.11294213387647956,0.4537787756084684,0.43326708370778283,0.11295414068374864,1,0,1,2,2,0,1
355,277,334,-78,-21,0.5334491639000349,0.3530491785312489,0.11350165756871632,0.5594903452637426,0.33716750247491345,0.1033421522613437,0,0,1,1,0,1,0
415,256,363,-159,-52,0.460588101526264,0.4199322025566096,0.11947969591712614,0.4782856384647961,0.4157993000996443,0.1059150614355596,1,0,1,1,2,1,0
394,439,465,45,71,0.5236373181632336,0.36073725486688674,0.11562542696987936,0.369675233349911,0.504215670079726,0.1261090965703631,1,1,1,3,4,0,1
430,320,408,-110,-22,0.4447960869387069,0.44200887108444425,0.11319504197684871,0.5046185379764574,0.38497618019578195,0.1104052818277609,1,0,1,1,2,1,0
327,212,280,-115,-47,0.43417556051032197,0.4515994730930327,0.11422496639664526,0.39065667159476636,0.4847933499531408,0.1245499784520931,0,0,2,1,0,1,0
359,189,210,-170,-149,0.5051881650404091,0.37842157683594596,0.11639025812364494,0.45947646651451574,0.4324556757087348,0.10806785777674943,1,0,1,3,2,1,0
284,255,269,-29,-15,0.4028086272203551,0.4875926437576964,0.10959872902194838,0.45973355286435313,0.42495088700213995,0.11531556013350701,1,0,2,2,2,1,0
327,263,315,-64,-12,0.4856821090620561,0.4027727792413217,0.11154511169662196,0.4020677627191332,0.4632197109535844,0.13471252632728237,1,0,2,1,2,1,0
291,221,286,-70,-5,0.4850862476084908,0.39793768636266874,0.1169760660288406,0.3490245710118495,0.5421812432515634,0.10879418573658693,0,0,1,1,0,1,0
332,227,382,-105,50,0.4285913608688587,0.4599270838903418,0.1114815552407991,0.37082991511999014,0.48298628213871053,0.14618380274129916,0,0,4,1,0,0,0
374,295,313,-79,-61,0.5458576614803261,0.3386732545759483,0.11546908394372539,0.4125303917343571,0.47684591777185553,0.11062369049378716,0,0,2,1,0,1,0
186,126,147,-60,-39,0.4478986228436923,0.4398156363962209,0.11228574076008686,0.42007257578145624,0.4719009912200576,0.10802643299848626,1,1,3,1,4,1,0
341,204,245,-137,-96,0.4745865029016056,0.4086120961613772,0.11680140093701752,0.34455781910984384,0.5314194635934363,0.12402271729672,0,0,1,1,0,1,0
286,243,263,-43,-23,0.4403479871756034,0.4469144252621419,0.11273758756225445,0.40096435474080505,0.4820898301684527,0.11694581509074223,1,0,1,2,2,1,0
351,237,367,-114,16,0.43299621935605875,0.4561462552710852,0.11085752537285604,0.3930233595783301,0.491530273237918,0.11544636718375191,0,0,1,1,0,0,0
247,192,212,-55,-35,0.4619682930620872,0.42685837438793933,0.11117333254997339,0.5516462692589138,0.3486678040344618,0.09968592670662423,0,0,3,1,0,1,0
343,258,314,-85,-29,0.47337310647896397,0.40400122942914773,0.12262566409188824,0.47672838579351695,0.37372097253242664,0.14955064167405632,1,1,1,1,4,1,0
244,181,222,-63,-22,0.4112384667859712,0.47374409714766935,0.11501743606635918,0.42128099737108765,0.45746633923285224,0.12125266339606033,1,0,1,1,2,1,0
172,200,299,28,127,0.48326777510748736,0.4033647971215772,0.11336742777093513,0.5122608286325457,0.37056383058330067,0.1171753407841537,0,0,1,1,0,0,1
348,207,280,-141,-68,0.5121363572861484,0.3754024814898481,0.11246116122400335,0.3875190398519856,0.49714906068447745,0.11533189946353693,0,0,1,1,0,1,0
275,237,349,-38,74,0.4662365187444386,0.42084972382946134,0.11291375742609987,0.5135586792611001,0.37025860110503456,0.11618271963386549,1,0,1,1,2,0,0
304,166,204,-138,-100,0.4698966789282472,0.41848187406959536,0.1116214470021576,0.44533263218666774,0.43984314071063857,0.1148242271026936,1,1,1,1,4,1,0
236,53,168,-183,-68,0.4495301137655869,0.4371412283531757,0.1133286578812374,0.466060196579303,0.4106339311618518,0.12330587225884512,0,1,1,1,1,1,0
4,21,49,17,45,0.4447960869387069,0.44200887108444425,0.11319504197684871,0.5046185379764574,0.38497618019578195,0.1104052818277609,1,1,1,1,4,0,1
313,250,282,-63,-31,0.4666433662047566,0.4202758416920475,0.11308079210319595,0.46234789646597724,0.41783103852036707,0.11982106501365535,1,0,1,2,2,1,0
319,328,360,9,41,0.40426698567757,0.4840972998587257,0.11163571446370446,0.38199732675597103,0.4565408508702911,0.16146182237373807,0,0,2,3,0,0,1
279,220,259,-59,-20,0.4713889910368562,0.41304072517852547,0.11557028378461821,0.4839263817829745,0.3982801980083186,0.11779342020870673,1,1,2,1,4,1,0
352,282,336,-70,-16,0.4293564938611317,0.4594551449436131,0.1111883611952551,0.42615427261313144,0.4467453789345189,0.12710034845234963,1,0,1,1,2,1,0
290,307,328,17,38,0.4617229950143364,0.421869611041763,0.11640739394390047,0.4448851914580803,0.4461522644060367,0.10896254413588316,0,0,4,5,0,0,1
338,282,301,-56,-37,0.4587953592745732,0.4226674926118677,0.11853714811355945,0.5092580900397659,0.3822902873869959,0.1084516225732385,1,0,2,2,3,1,0
421,327,382,-94,-39,0.4752957620966021,0.41301887307599955,0.11168536482739842,0.4235748020984111,0.45550369880157004,0.12092149910001888,0,1,1,3,1,1,0
294,203,269,-91,-25,0.445491677639653,0.4432001882181937,0.11130813414215344,0.38713195471991224,0.47544093933203435,0.13742710594805344,1,1,1,1,4,1,0
348,260,299,-88,-49,0.419240936802661,0.4704306310813584,0.11032843211598058,0.37834623271548695,0.4972067343608149,0.12444703292369838,1,1,1,2,4,1,0
369,430,445,61,76,0.47972533689757046,0.40816172708532417,0.11211293601710522,0.3211730973459217,0.5448585285259134,0.13396837412816454,1,0,1,1,2,0,1
294,240,285,-54,-9,0.42830803844028204,0.4575901270284345,0.11410183453128349,0.41697998305163675,0.4752046342283639,0.10781538271999923,1,0,2,3,3,1,0
411,355,395,-56,-16,0.46409133286953463,0.4201162363219439,0.11579243080852158,0.5269162427779454,0.36431165715323843,0.10877210006881624,0,0,1,1,0,1,0
263,187,246,-76,-17,0.44610661237510324,0.4402867153661413,0.11360667225875506,0.5303719054944971,0.3591906269524157,0.1104374675530872,1,1,1,1,4,1,0
144,103,137,-41,-7,0.44332960375016156,0.44188615088270283,0.11478424536713551,0.42567604152919086,0.4480489391626229,0.1262750193081863,0,1,1,2,1,1,0
307,138,162,-169,-145,0.42511103789096877,0.46428261257885656,0.11060634953017454,0.44622293822173137,0.4270874521839142,0.12668960959435446,1,0,1,1,2,1,0
344,194,262,-150,-82,0.44240100995392645,0.44444161382492414,0.11315737622114909,0.4206226976008516,0.4540822225997775,0.12529507979937093,1,0,1,2,3,1,0
346,184,370,-162,24,0.3870527168966094,0.5019762788604266,0.11097100424296427,0.5070506928983501,0.38870749220116224,0.1042418149004876,0,0,2,1,0,0,0
396,292,313,-104,-83,0.45099878840699414,0.43812264812487745,0.1108785634681284,0.40658923755482573,0.4639671604693678,0.12944360197580623,1,0,1,2,2,1,0
287,174,266,-113,-21,0.4446795531687448,0.4421250784183937,0.11319536841286151,0.3989520284188098,0.4916841980810833,0.10936377350010697,1,0,3,3,2,1,0
287,129,217,-158,-70,0.3354935086979478,0.5514437269696036,0.11306276433244863,0.23327053431361466,0.6173024393014764,0.14942702638490893,0,1,2,2,1,1,0
255,219,244,-36,-11,0.46922244380080985,0.4144414403054892,0.1163361158937008,0.3854507928782728,0.48702781283756374,0.1275213942841635,1,0,2,1,2,1,0
464,307,361,-157,-103,0.46649400977054334,0.4170281632486106,0.11647782698084594,0.4213388878025895,0.46314842292946157,0.11551268926794897,1,1,1,1,4,1,0
178,198,220,20,42,0.4362295674094671,0.453565896944132,0.11020453564640076,0.49908205492299823,0.389779454131257,0.11113849094574485,1,0,2,2,2,0,1
1135,971,1098,-164,-37,0.4729401786211403,0.41227373491144054,0.11478608646741874,0.46503225559966854,0.37277198625248925,0.16219575814784173,1,0,1,4,2,1,0
324,200,278,-124,-46,0.46914532654515184,0.41810186971796476,0.1127528037368832,0.42188734611501133,0.46241784890412685,0.11569480498086175,1,1,1,2,4,1,0
308,167,252,-141,-56,0.37308129286943686,0.5136298308665775,0.1132888762639858,0.4037922984515742,0.48589820643457743,0.11030949511384806,0,0,1,1,0,1,0
344,254,273,-90,-71,0.4683555434397398,0.41332908733962215,0.11831536922063822,0.5477315372158186,0.3486816533165579,0.10358680946762346,0,1,1,1,1,1,0
293,306,334,13,41,0.48100050344196693,0.40489298327697354,0.11410651328105936,0.443898965631176,0.4423093601640826,0.11379167420474144,1,0,1,3,2,0,1
405,343,364,-62,-41,0.4343412991365599,0.45445830629125283,0.11120039457218736,0.3725565895250884,0.5106424973442574,0.11680091313065406,0,1,3,2,1,1,0
307,243,276,-64,-31,0.43024165667969044,0.457270115446672,0.1124882278736373,0.3792864106466315,0.5129138319761413,0.10779975737722759,1,1,4,4,4,1,0
329,205,391,-124,62,0.43033236945862835,0.4545909117436266,0.11507671879774503,0.2468159617787918,0.6420937042910096,0.11109033393019871,1,0,1,1,2,0,0
492,113,434,-379,-58,0.4447960869387069,0.44200887108444425,0.11319504197684871,0.5046185379764574,0.38497618019578195,0.1104052818277609,1,1,1,1,4,1,0
316,400,447,84,131,0.40423013431635285,0.4760414926358864,0.11972837304776053,0.3294019374231378,0.5160526590778259,0.15454540349903623,1,0,1,4,2,0,1
272,203,296,-69,24,0.4837906603853837,0.39968203509686345,0.11652730451775266,0.452507400001378,0.4431687083916674,0.10432389160695456,1,0,1,2,2,0,0
416,342,367,-74,-49,0.40972884531833925,0.4712125749424653,0.11905857973919542,0.4760697541358578,0.4140335413988811,0.10989670446526106,1,0,1,2,2,1,0
358,234,262,-124,-96,0.5256921583438244,0.3602592682548402,0.1140485734013353,0.49260460502093345,0.39385985782742294,0.11353553715164345,1,0,2,1,2,1,0
330,247,310,-83,-20,0.4317235082054422,0.45537804230010503,0.11289844949445263,0.3784292595986531,0.5036307864680069,0.11793995393333996,1,1,2,1,4,1,0
323,371,388,48,65,0.47734232201730187,0.41176423745927093,0.1108934405234271,0.5204982853086743,0.3700132895059202,0.10948842518540547,1,0,2,1,2,0,1
140,0,103,-140,-37,0.48228970215751815,0.40583132277149475,0.11187897507098721,0.40076295127097705,0.4796762613113307,0.1195607874176924,0,0,1,1,0,1,0
410,295,369,-115,-41,0.4154936066874659,0.4664129661275618,0.11809342718497254,0.25396926192362995,0.6189127296601183,0.1271180084162518,0,1,1,1,1,1,0
352,266,308,-86,-44,0.4748594615100105,0.40329899375834727,0.12184154473164222,0.32246775583758724,0.5652710341545449,0.11226121000786767,0,1,1,1,1,1,0
252,83,211,-169,-41,0.4498866810667544,0.43871144800140793,0.11140187093183727,0.49954426340196756,0.3953451698485679,0.10511056674946462,1,1,1,1,4,1,0
315,195,236,-120,-79,0.4586043047921499,0.4247053429316773,0.11669035227617305,0.4871240193898904,0.40395635720366013,0.10891962340644927,1,1,1,1,4,1,0
343,379,460,36,117,0.47207390460748383,0.4177843736095396,0.11014172178297633,0.4889874298264543,0.4029522546919963,0.1080603154815493,1,0,1,1,2,0,1
243,157,201,-86,-42,0.44484432716540084,0.442895299324286,0.11226037351031326,0.34140446954761816,0.5326436075476447,0.12595192290473714,1,1,1,2,4,1,0
248,322,332,74,84,0.42699130221737175,0.46373278844155313,0.10927590934107505,0.4376981061166338,0.42206690563758786,0.14023498824577837,0,0,1,2,0,0,1
152,14,75,-138,-77,0.5016251927691925,0.3828586904675367,0.11551611676327053,0.4837527101838766,0.4151721534635525,0.10107513635257072,1,1,1,1,4,1,0
275,205,264,-70,-11,0.43160663612547256,0.44994718084052876,0.11844618303399855,0.49397281349344657,0.38385845997310997,0.12216872653344331,1,0,1,1,2,1,0
320,269,282,-51,-38,0.4251732050816979,0.4629444991273539,0.11188229579094812,0.3901437960541017,0.4882001825596139,0.1216560213862843,1,1,2,1,4,1,0
315,335,428,20,113,0.4627717389463605,0.42272308017723786,0.11450518087640174,0.38021673256322464,0.5045231168871579,0.11526015054961747,1,1,2,2,4,0,1
302,194,287,-108,-15,0.4483915151142128,0.43778292129145585,0.11382556359433141,0.4285362226210066,0.4480658641896311,0.12339791318936236,0,1,2,2,1,1,0
356,233,266,-123,-90,0.4109967871583155,0.478957766715447,0.11004544612623711,0.35194094289592864,0.5295469805158474,0.11851207658822435,1,0,2,1,2,1,0
280,297,320,17,40,0.5002905016434647,0.38335069556443097,0.11635880279210432,0.38097565924789273,0.5050975056802857,0.1139268350718216,1,0,2,1,2,0,1
237,288,305,51,68,0.4683852527182229,0.41932773556589464,0.11228701171588233,0.46667275122099805,0.4037017888150578,0.12962545996394442,1,0,1,1,2,0,1
315,262,287,-53,-28,0.4480023803752759,0.43709134832544483,0.11490627129927915,0.38151739098621373,0.5085541684546877,0.10992844055909835,1,1,1,5,4,1,0
321,336,361,15,40,0.45128704899339944,0.4291884197348831,0.11952453127171746,0.3460994512680095,0.5138693639414105,0.14003118479058016,1,0,1,2,2,0,1
358,300,335,-58,-23,0.38781178143421197,0.50365633268898,0.10853188587680798,0.4149840695026069,0.4733352680113901,0.11168066248600271,0,1,1,2,1,1,0
277,104,209,-173,-68,0.46460410580577016,0.4214440937974055,0.11395180039682434,0.3962337991242102,0.4756561388451925,0.1281100620305974,0,1,1,1,1,1,0
328,193,200,-135,-128,0.4108337591597812,0.4764867663555871,0.1126794744846318,0.39767585915835846,0.4752533152842919,0.12707082555734972,0,1,1,1,1,1,0
333,225,264,-108,-69,0.48099323358631907,0.39979858288355147,0.11920818353012932,0.4179165959645677,0.4641048537745818,0.1179785502608506,1,1,2,2,4,1,0
367,318,522,-49,155,0.4430417920797206,0.44014884430818635,0.1168093636120931,0.4618781296810338,0.40973381011643395,0.12838806020253227,1,0,2,1,2,0,0
407,231,452,-176,45,0.37998874429246676,0.5070551627415373,0.11295609296599614,0.35248393620443275,0.5240311826862797,0.12348488110928771,1,0,3,1,2,0,0
295,230,242,-65,-53,0.4360477443253762,0.44748300363197363,0.11646925204264998,0.5145419514104892,0.3820160750622215,0.10344197352728936,0,0,3,2,0,1,0
386,246,341,-140,-45,0.43189161720954833,0.4540712528853789,0.11403712990507262,0.4596087258847424,0.4274694386078853,0.11292183550737199,1,0,1,2,2,1,0
327,294,310,-33,-17,0.3804343824562963,0.509558939106074,0.11000667843762942,0.33108577988128485,0.5448182914145183,0.12409592870419657,1,0,1,4,2,1,0
353,152,180,-201,-173,0.5032908761201084,0.3777220506470729,0.11898707323281862,0.3852017379878011,0.48310546050341246,0.13169280150878637,1,1,1,1,4,1,0
282,195,274,-87,-8,0.4640216745522516,0.4256767099563348,0.11030161549141364,0.4884410311824117,0.4099339548064464,0.10162501401114163,0,1,3,2,1,1,0
68,20,46,-48,-22,0.4447960869387069,0.44200887108444425,0.11319504197684871,0.5046185379764574,0.38497618019578195,0.1104052818277609,1,1,1,1,4,1,0
276,104,128,-172,-148,0.4341005867842428,0.45349587250824913,0.11240354070750778,0.32316650196752594,0.5614833938990403,0.11535010413343337,0,1,1,1,1,1,0
269,146,201,-123,-68,0.44029594424539076,0.4471572191763346,0.11254683657827451,0.49541868502145603,0.3846262091981803,0.11995510578036375,0,1,1,1,1,1,0
223,176,204,-47,-19,0.5238523760004197,0.3625340256034607,0.11361359839611979,0.424094440235621,0.4522618306966241,0.12364372906775481,1,0,1,1,2,1,0
379,331,366,-48,-13,0.49173888699746143,0.394351875616346,0.11390923738619244,0.4725432499998183,0.41552888658423587,0.11192786341594571,1,0,3,1,2,1,0
344,144,234,-200,-110,0.4397040696044425,0.446658277677397,0.11363765271816041,0.4205602146622378,0.4446838724874104,0.13475591285035157,0,0,1,1,0,1,0
210,162,188,-48,-22,0.4307690508599973,0.4570514874348386,0.11217946170516396,0.518037997946412,0.3760368160132837,0.10592518604030449,1,0,2,1,2,1,0
313,192,219,-121,-94,0.436487820054059,0.45245790230559624,0.11105427764034445,0.3788047872752433,0.5094751352956222,0.11172007742913447,1,0,2,2,3,1,0
268,297,343,29,75,0.4655500622295241,0.4168264723385167,0.11762346543195916,0.40562838496732107,0.4526536810308461,0.14171793400183275,1,0,1,1,2,0,1
387,142,308,-245,-79,0.4527606039170696,0.4352220980308382,0.11201729805209194,0.5087755774902168,0.3667045911779307,0.12451983133185221,1,1,1,3,4,1,0
265,312,330,47,65,0.444448929948788,0.44019462021506117,0.11535644983615098,0.4552771578420304,0.43408708323746403,0.11063575892050535,1,0,2,3,2,0,1
341,308,324,-33,-17,0.3952202961530973,0.4923263258708537,0.11245337797604914,0.37272289928739605,0.49938904122381594,0.1278880594887878,1,1,2,3,4,1,0
435,567,702,132,267,0.42855403521942664,0.4617740488969865,0.10967191588358695,0.3929629294317686,0.49482914474084366,0.1122079258273877,0,0,2,1,0,0,1
3,33,135,30,132,0.4447960869387069,0.44200887108444425,0.11319504197684871,0.5046185379764574,0.38497618019578195,0.1104052818277609,1,1,1,1,4,0,1
427,381,398,-46,-29,0.4577475880104158,0.4248627684802213,0.11738964350936276,0.5226715361873601,0.36625970992080215,0.11106875389183772,1,0,1,1,2,1,0
336,237,302,-99,-34,0.4481656821613361,0.4387406311839565,0.113093686654707,0.3029833267838093,0.5788430965804402,0.11817357663575025,0,1,1,2,1,1,0
235,193,222,-42,-13,0.40681932097108725,0.4831101574985196,0.11007052153039291,0.41696179478780787,0.466468891285734,0.11656931392645825,1,1,2,3,4,1,0
283,160,234,-123,-49,0.4455259987513637,0.4419864749952308,0.11248752625340526,0.4895676515907518,0.3914390183459965,0.11899333006325181,1,0,1,1,3,1,0
337,211,306,-126,-31,0.469297448766675,0.4198729698446457,0.11082958138867906,0.4908938650270141,0.39761417031417184,0.11149196465881382,0,0,1,3,0,1,0
275,115,186,-160,-89,0.43702402597309115,0.4495139767948822,0.1134619972320265,0.5066688582554455,0.3849749254202211,0.10835621632433355,1,0,2,1,2,1,0
339,361,381,22,42,0.4423275299332934,0.4455234029622531,0.11214906710445358,0.29534949964789975,0.5783594795973424,0.1262910207547579,1,0,1,2,2,0,1
558,838,849,280,291,0.5029305892783723,0.38358560888464777,0.11348380183697981,0.3524775002435986,0.5395941370861531,0.10792836267024827,1,1,2,3,4,0,1
400,315,326,-85,-74,0.4515717644817786,0.43436716472624587,0.11406107079197564,0.3842000758450548,0.5044326435077148,0.11136728064723066,0,1,2,2,1,1,0
355,338,350,-17,-5,0.47553924865335484,0.4150242748199725,0.10943647652667261,0.44917360967651665,0.4388134995609906,0.11201289076249274,1,0,1,1,2,1,0
377,409,517,32,140,0.3987239714273253,0.4911363070787789,0.11013972149389566,0.3506514219069301,0.5270900360826567,0.12225854201041324,1,0,1,1,2,0,1
266,205,301,-61,35,0.43118738163550374,0.4555637040291193,0.1132489143353771,0.3864309876847875,0.48721163032239034,0.12635738199282204,1,1,2,2,4,0,0
280,275,293,-5,13,0.4207265514127832,0.4579447128663985,0.12132873572081826,0.3650931644001421,0.484029555897793,0.15087727970206458,1,0,2,1,2,0,0
229,241,276,12,47,0.46279190481532223,0.42287095132800684,0.11433714385667085,0.48243872638208934,0.4126039801474175,0.104957293470493,1,1,1,2,4,0,1
242,179,201,-63,-41,0.39196109337700447,0.499700926307049,0.10833798031594671,0.308306344591753,0.5646437410809799,0.12704991432726687,1,0,1,2,2,1,0
322,208,280,-114,-42,0.5104933120245839,0.3770464061693993,0.11246028180601693,0.46719134956545183,0.4257953976505634,0.10701325278398467,1,0,2,2,2,1,0
380,251,267,-129,-113,0.4739620096862951,0.41301147350373657,0.11302651680996782,0.4106892537948147,0.4666165733163363,0.12269417288884894,1,0,1,1,2,1,0
353,256,278,-97,-75,0.4319261244723447,0.4536510179331064,0.11442285759454875,0.5277294038111824,0.3696482388361724,0.10262235735264509,0,0,1,1,0,1,0
239,144,169,-95,-70,0.4961173899707666,0.38596322468309113,0.11791938534614219,0.43663579057439283,0.44224444674811414,0.12111976267749294,1,0,2,1,2,1,0
277,180,196,-97,-81,0.41857101862680474,0.46850335590973674,0.11292562546345856,0.32261050434619837,0.5599333790246553,0.11745611662914608,0,0,1,1,0,1,0
285,234,261,-51,-24,0.4389051071827461,0.4465249329133914,0.11456995990386244,0.41724469649464135,0.45706195445094033,0.12569334905441834,1,1,1,3,4,1,0
366,216,272,-150,-94,0.49278133726918744,0.39197227825108166,0.11524638447973073,0.4164178514317217,0.46988453511573997,0.11369761345253836,0,1,1,2,1,1,0
281,4,115,-277,-166,0.4447960869387069,0.44200887108444425,0.11319504197684871,0.5046185379764574,0.38497618019578195,0.1104052818277609,1,0,1,1,2,1,0
728,425,664,-303,-64,0.558867331642268,0.3212212671332757,0.11991140122445614,0.32595481977638313,0.5492150970238987,0.12483008319971782,0,0,3,1,0,1,0
272,127,261,-145,-11,0.4492524885572543,0.4371522456901709,0.11359526575257455,0.4159784342169954,0.4603757602287327,0.12364580555427196,0,1,1,1,1,1,0
474,310,341,-164,-133,0.4932731850600692,0.3908783356552068,0.11584847928472404,0.4749160324669257,0.4079940410612314,0.11708992647184274,1,1,1,2,4,1,0
381,245,348,-136,-33,0.4597089768893736,0.42802422861162065,0.11226679449900547,0.36972356466322437,0.5061910121071675,0.124085423229608,0,1,2,1,1,1,0
281,273,306,-8,25,0.44497267550169894,0.4410945936038044,0.11393273089449657,0.48273497058790393,0.3995799075765944,0.11768512183550146,1,0,1,2,2,0,0
645,578,640,-67,-5,0.41518867901052675,0.4686878534567027,0.1161234675327703,0.3321528582140897,0.548609009355506,0.11923813243040458,0,0,2,1,0,1,0
417,301,467,-116,50,0.5422314907708176,0.34283306327134816,0.11493544595783427,0.3703325171775068,0.5162654536253816,0.11340202919711115,0,0,2,1,0,0,0
179,134,154,-45,-25,0.46143570856132604,0.4263370089518284,0.11222728248684563,0.4827009739566006,0.39795566490271417,0.11934336114068561,1,0,1,1,2,1,0
285,162,247,-123,-38,0.4334727557648462,0.45294256487105367,0.11358467936410019,0.4082037048665442,0.47399719042547656,0.11779910470797926,0,0,2,1,0,1,0
323,258,297,-65,-26,0.43787620075598643,0.44916948597868867,0.11295431326532501,0.35106780425909556,0.5359482638617921,0.11298393187911251,0,0,2,1,0,1,0
493,265,291,-228,-202,0.37979992948659785,0.5074530077534734,0.11274706275992884,0.46795314514585507,0.4147644237507835,0.11728243110336117,0,0,1,2,0,1,0
397,262,347,-135,-50,0.4574793766547757,0.4274950912649989,0.11502553208022513,0.43782284181172965,0.4489415487684436,0.11323560941982701,0,1,2,2,1,1,0
387,346,359,-41,-28,0.3969578613785859,0.49395656342510097,0.10908557519631287,0.37479331679343764,0.5017056999998122,0.12350098320675011,1,1,1,1,4,1,0
279,185,247,-94,-32,0.46400231014733756,0.41866685305536144,0.11733083679730114,0.41011188548737393,0.4654557354934378,0.12443237901918819,0,1,2,3,1,1,0
725,648,705,-77,-20,0.4618760042273841,0.41867984935809643,0.11944414641451927,0.38051739898538384,0.46927980341669373,0.1502027975979223,0,1,2,5,1,1,0
485,338,395,-147,-90,0.4072769974540095,0.4770048659465473,0.1157181365994432,0.2750138280071226,0.5809900666767044,0.14399610531617293,0,0,1,3,0,1,0
366,288,329,-78,-37,0.46220629514358424,0.424065745950689,0.11372795890572661,0.42619788123429625,0.4487142445914018,0.12508787417430145,1,0,3,1,2,1,0
291,55,493,-236,202,0.44097611541454285,0.44621408346609076,0.11280980111936635,0.42034934933329565,0.4753713262155633,0.10427932445114077,0,0,1,1,0,0,0
503,330,347,-173,-156,0.4811999970980444,0.4042417866656287,0.11455821623632709,0.48485309801165755,0.401304880383619,0.11384202160472348,1,0,1,2,2,1,0
263,234,249,-29,-14,0.449241826406324,0.4403902997062962,0.1103678738873797,0.49914970909113987,0.3900109540328284,0.11083933687603188,1,0,2,2,2,1,0
326,192,289,-134,-37,0.42665317107508316,0.4578859322325486,0.11546089669236831,0.4570230226760064,0.4296928230440988,0.11328415427989448,1,1,1,2,4,1,0
316,230,286,-86,-30,0.47554344407929844,0.40881042058490874,0.11564613533579267,0.41223352214147474,0.45940814630562826,0.12835833155289697,1,1,3,3,4,1,0
339,233,292,-106,-47,0.46867140530505025,0.4174790728124502,0.11384952188249908,0.4687260387229293,0.42113952309868286,0.11013443817838801,1,1,2,1,4,1,0
283,189,270,-94,-13,0.5241786742168079,0.35793410359909994,0.11788722218409226,0.43116972582050805,0.4672590163703409,0.10157125780915101,0,0,2,1,0,1,0
134,0,79,-134,-55,0.46331725101331345,0.42263884705760907,0.1140439019290772,0.41780011214152574,0.46443653862761475,0.11776334923085954,0,1,2,1,1,1,0
472,415,443,-57,-29,0.43360956833956926,0.4516259139537599,0.11476451770667045,0.4830509273274511,0.43246716544842767,0.08448190722412127,1,0,2,2,2,1,0
256,198,217,-58,-39,0.45729986455549065,0.4285696314213997,0.11413050402310956,0.49760523627528697,0.3700849754307543,0.1323097882939587,0,0,1,1,0,1,0
327,209,247,-118,-80,0.43925915684369443,0.4453349670688673,0.11540587608743816,0.40223774898070086,0.47341448779807904,0.12434776322121999,0,1,1,1,1,1,0
379,275,351,-104,-28,0.505786600671613,0.3743927680656296,0.11982063126275751,0.3327599959506491,0.542032102761412,0.12520790128793916,0,0,1,1,0,1,0
521,360,488,-161,-33,0.46222955524910114,0.4259698551585175,0.11180058959238129,0.4572811268525696,0.4195076901571363,0.1232111829902941,1,0,1,1,2,1,0
283,210,247,-73,-36,0.4769928939390223,0.4120206938703409,0.11098641219063698,0.521989040115212,0.36728009499717995,0.11073086488760779,0,0,1,1,0,1,0
314,336,349,22,35,0.4117219413238964,0.4761659393782566,0.11211211929784691,0.473696952530398,0.4107280286285171,0.11557501884108544,1,0,1,3,2,0,1
507,372,534,-135,27,0.4056335294949577,0.4786022078758318,0.11576426262921055,0.42150475242217267,0.4181824425119825,0.16031280506584472,0,0,2,2,0,0,0
297,322,362,25,65,0.44496018790809966,0.44145975994704745,0.11358005214485252,0.4506207827820884,0.44496266038823756,0.10441655682967395,1,1,3,2,4,0,1
300,222,312,-78,12,0.46242380490536694,0.4244646268869282,0.11311156820770459,0.4096379755399939,0.4600275243003753,0.13033450015963072,1,0,1,1,2,0,0
343,286,331,-57,-12,0.47870455861991446,0.406199853768443,0.11509558761164264,0.5288400507879006,0.375393665884548,0.09576628332755147,1,1,3,3,4,1,0
311,179,213,-132,-98,0.45946406898568715,0.4244455659217499,0.11609036509256274,0.4138148300122394,0.46094876537702156,0.12523640461073926,0,0,2,1,0,1,0
337,249,280,-88,-57,0.4655460131815539,0.4219637993437525,0.1124901874746935,0.3736281774600032,0.5052268513488702,0.12114497119112652,0,1,1,1,1,1,0
331,286,342,-45,11,0.4170353437150146,0.4709336944959725,0.11203096178901267,0.5364404342057928,0.36150246742474323,0.10205709836946375,1,0,1,3,2,0,0
288,237,273,-51,-15,0.4945091032618423,0.39351780518838364,0.11197309154977396,0.46099939924096694,0.4260493434177599,0.11295125734127322,0,0,1,1,0,1,0
295,169,205,-126,-90,0.44367875083163855,0.4423034872727697,0.11401776189559189,0.44334612229660786,0.4343855866668001,0.12226829103659215,1,1,4,4,4,1,0
397,345,409,-52,12,0.5148282966966067,0.3689999482064008,0.11617175509699255,0.42971451900759194,0.4728080367646024,0.09747744422780548,1,0,1,4,2,0,0
200,279,321,79,121,0.4364115455603279,0.4462702257062762,0.11731822873339605,0.41620517638004506,0.46108588507554643,0.12270893854440841,0,0,1,1,0,0,1
510,428,453,-82,-57,0.45487346487210906,0.4279085046674293,0.1172180304604617,0.32006930124351696,0.5592297194241559,0.12070097933232714,0,1,1,1,1,1,0
346,356,396,10,50,0.4220479650941418,0.4662739803718247,0.11167805453403361,0.48064558019128323,0.37893695816556816,0.1404174616431486,1,1,1,1,4,0,1
356,393,465,37,109,0.4531440325139286,0.4328386311317673,0.11401733635430415,0.44106435067900246,0.4482493244598956,0.11068632486110193,0,1,1,1,1,0,1
277,239,250,-38,-27,0.4447960869387069,0.44200887108444425,0.11319504197684871,0.5046185379764574,0.38497618019578195,0.1104052818277609,0,0,1,1,0,1,0
377,211,330,-166,-47,0.48983556962530256,0.39572100181168895,0.11444342856300825,0.4968843461824774,0.38711541226016816,0.11600024155735404,0,0,2,1,0,1,0
216,229,277,13,61,0.44400913045195545,0.44108389826201577,0.11490697128602854,0.45227556259734214,0.420130528707422,0.12759390869523554,1,0,2,1,2,0,1
231,163,193,-68,-38,0.42512061437041987,0.4614417298390595,0.11343765579052048,0.5134640075935611,0.3783527483694602,0.1081832440369787,0,0,3,2,0,1,0
407,269,301,-138,-106,0.45698386605540436,0.4322734795101703,0.1107426544344252,0.45331828645065386,0.44402421647745927,0.10265749707188672,0,1,3,1,1,1,0
238,98,198,-140,-40,0.4447960869387069,0.44200887108444425,0.11319504197684871,0.5046185379764574,0.38497618019578195,0.1104052818277609,1,1,1,2,4,1,0
150,0,114,-150,-36,0.4879792600839211,0.39758904689997093,0.11443169301610812,0.4557683975765672,0.4288691674313777,0.11536243499205528,0,1,1,1,1,1,0
407,291,372,-116,-35,0.4447960869387069,0.44200887108444425,0.11319504197684871,0.5046185379764574,0.38497618019578195,0.1104052818277609,0,0,1,1,0,1,0
210,244,319,34,109,0.464657176403603,0.42030610716218897,0.11503671643420792,0.4100328294635721,0.47050972437487826,0.11945744616154963,1,0,3,3,2,0,1
203,160,186,-43,-17,0.5027230006157133,0.38547421176376984,0.11180278762051675,0.5006781704263454,0.38152955703396946,0.1177922725396844,0,0,1,1,0,1,0
341,257,330,-84,-11,0.4518145319850021,0.4345193073373082,0.11366616067768967,0.5127386616898255,0.37299376905960374,0.11426756925057066,0,0,2,1,0,1,0
232,185,214,-47,-18,0.43502189406923,0.45359914221421826,0.11137896371655172,0.4476605723547833,0.44019503765913015,0.11214438998608652,1,1,1,3,4,1,0
322,251,304,-71,-18,0.474797271656418,0.4098070932662283,0.11539563507735381,0.4647248254326302,0.4300529288407745,0.10522224572659532,0,0,1,1,0,1,0
359,279,344,-80,-15,0.39452711737264745,0.49456734607870634,0.1109055365486464,0.3110582108670066,0.5645829454075834,0.12435884372540978,1,0,1,1,2,1,0
378,282,324,-96,-54,0.45112713070616095,0.43301666728550764,0.11585620200833124,0.46472406749273976,0.4257994075376258,0.10947652496963453,1,1,3,1,4,1,0
344,270,315,-74,-29,0.44735641394738235,0.43798708015569815,0.11465650589691949,0.4364519264891325,0.43873574867331216,0.12481232483755535,0,1,2,1,1,1,0
327,126,158,-201,-169,0.43482087102252154,0.4464622389068469,0.1187168900706318,0.39560840462891145,0.46023869475140544,0.14415290061968306,1,1,1,1,4,1,0
347,300,328,-47,-19,0.41373965881227787,0.47000740978625605,0.11625293140146617,0.4827281782160805,0.3827623974095176,0.13450942437440175,0,0,4,2,0,1,0
263,238,250,-25,-13,0.4225850605196346,0.4631122518837005,0.11430268759666479,0.424713733283286,0.46437667871246163,0.11090958800425252,1,0,2,2,2,1,0
248,218,225,-30,-23,0.38812669187157545,0.5021456355471928,0.10972767258123171,0.4259726804405517,0.45121144416811,0.12281587539133812,1,0,1,2,3,1,0
257,181,207,-76,-50,0.4647463672280603,0.4209202897991853,0.11433334297275415,0.3974225593976714,0.4759046239611125,0.12667281664121607,0,0,4,2,0,1,0
262,171,209,-91,-53,0.4685241346390477,0.4167892975261303,0.11468656783482203,0.5136200964353308,0.37131785904728754,0.11506204451738156,0,1,1,4,1,1,0
422,311,364,-111,-58,0.41913628215880155,0.4646971668817795,0.11616655095941887,0.4461135929239,0.4342485395196579,0.11963786755644205,1,1,3,3,4,1,0
310,178,221,-132,-89,0.4923848774265598,0.392680571344934,0.11493455122850653,0.3691277673229469,0.519377765489419,0.11149446718763452,0,0,3,1,0,1,0
449,233,406,-216,-43,0.4322523526338124,0.45492068094513083,0.11282696642105668,0.4024063796010099,0.4582442755055117,0.13934934489347822,1,1,1,1,4,1,0
324,278,311,-46,-13,0.42829789397243695,0.45936466166099027,0.1123374443665725,0.301396448503013,0.5873692665507558,0.1112342849462314,1,1,3,1,4,1,0
237,144,169,-93,-68,0.451613335329827,0.435971941207522,0.11241472346265083,0.4215156706803795,0.4680421685532983,0.11044216076632193,1,0,1,1,2,1,0
354,286,315,-68,-39,0.5147741529071176,0.3708169810666608,0.11440886602622152,0.43525038501064844,0.4284896583281534,0.13625995666119817,0,1,2,1,1,1,0
360,190,262,-170,-98,0.44900815121113075,0.43864578454425157,0.1123460642446177,0.3238068364551252,0.5773022612057007,0.09889090233917412,0,0,1,1,0,1,0
315,190,227,-125,-88,0.47381383342321143,0.41289164406593903,0.11329452251084957,0.46450162988903276,0.4082906760613524,0.12720769404961493,0,1,1,1,1,1,0
359,257,274,-102,-85,0.43339330689364824,0.4470419977978337,0.11956469530851822,0.4531677883148471,0.42175871847278873,0.12507349321236427,1,0,1,2,2,1,0
329,260,317,-69,-12,0.47880845069696665,0.40524129662627595,0.11595025267675722,0.37510151339158115,0.4928928566924655,0.13200562991595358,0,0,2,1,0,1,0
327,281,351,-46,24,0.4246680750809512,0.4649798804052784,0.11035204451377044,0.4614462299787976,0.4232083469568517,0.11534542306435026,1,0,1,3,2,0,0
272,136,232,-136,-40,0.42519932435141966,0.4627630677564853,0.11203760789209516,0.5251194424790204,0.3642764327872653,0.1106041247337142,1,0,1,1,2,1,0
231,0,77,-231,-154,0.45696710760969805,0.428838214800677,0.11419467758962507,0.4012209114223974,0.48728037559432735,0.11149871298327499,1,1,1,1,4,1,0
349,389,400,40,51,0.4050009597988449,0.48605983576003314,0.10893920444112197,0.2893720709089723,0.5817206321674461,0.12890729692358155,0,1,1,2,1,0,1
290,218,240,-72,-50,0.40162899535754853,0.48696425644798785,0.11140674819446389,0.351854520502337,0.5218957158757309,0.12624976362193152,0,0,1,1,0,1,0
348,213,378,-135,30,0.43041496135279705,0.4545737333375784,0.11501130530962478,0.37137811998299997,0.5122808263895535,0.11634105362744658,1,1,1,2,4,0,0
278,157,199,-121,-79,0.38784529676063023,0.5008176164589245,0.11133708678044536,0.4713261479613364,0.4123417552397303,0.11633209679893362,0,1,1,1,1,1,0
278,201,250,-77,-28,0.4684684774603989,0.4139712165578021,0.1175603059817987,0.45391744439404835,0.43289862818799724,0.11318392741795394,1,1,1,2,4,1,0
273,277,340,4,67,0.4742117629195967,0.411088384339363,0.11469985274104023,0.4369324792302986,0.424285244445994,0.13878227632370743,1,0,2,1,2,0,1
735,672,762,-63,27,0.4781259605203803,0.40888767713301116,0.11298636234660843,0.24155888451370439,0.6496072996637066,0.10883381582258908,1,0,1,4,2,0,0
365,219,340,-146,-25,0.47069897276406414,0.4174439896692577,0.11185703756667788,0.38379687912754423,0.47899903056702436,0.1372040903054314,0,0,1,2,0,1,0
392,309,449,-83,57,0.3840752794897391,0.503016479681967,0.11290824082829386,0.3527717920131997,0.5146082536640045,0.13261995432279566,0,0,2,2,0,0,0
305,73,196,-232,-109,0.4891703074527264,0.3964697196062701,0.11435997294100365,0.45948371874804333,0.40996524388691025,0.1305510373650468,1,0,1,1,2,1,0
367,251,311,-116,-56,0.46972368047393565,0.41076782731110145,0.11950849221496282,0.42244387698485236,0.47780410638390547,0.09975201663124234,0,0,1,1,0,1,0
159,0,129,-159,-30,0.46834019441936264,0.41508903236987327,0.11657077321076421,0.49527767803101436,0.38470024508527045,0.12002207688371481,0,0,1,1,0,1,0
204,156,174,-48,-30,0.4092273048256377,0.47609410074579367,0.11467859442856887,0.353506125921909,0.5434952173606762,0.10299865671741487,0,0,1,1,0,1,0
265,199,243,-66,-22,0.4192574753960565,0.46403792950092276,0.1167045951030207,0.38826960094862434,0.4784690913415446,0.13326130770983122,1,0,2,4,3,1,0
369,7,26,-362,-343,0.4640389959634116,0.42349676444947404,0.11246423958711446,0.5385454397803034,0.35411306771693796,0.10734149250275843,1,0,1,1,2,1,0
286,234,243,-52,-43,0.45877131611515304,0.42480614635535163,0.11642253752949519,0.43811839890878057,0.4545655522526104,0.1073160488386087,0,0,3,1,0,1,0
167,145,157,-22,-10,0.47969579161802556,0.40449504200909736,0.11580916637287718,0.37493408026859104,0.5273391020106251,0.09772681772078365,0,1,2,1,1,1,0
257,147,233,-110,-24,0.4262424773775395,0.4632660400273799,0.11049148259508025,0.38387407169870186,0.46985937342227924,0.14626655487901868,0,1,4,1,1,1,0
562,381,532,-181,-30,0.4717868667486721,0.4068077702592891,0.12140536299203877,0.42224449858989915,0.45404710499242945,0.12370839641767163,0,1,1,2,1,1,0
185,226,266,41,81,0.4676944760919909,0.4200930154728405,0.11221250843516849,0.44611722353254457,0.43873348611706886,0.1151492903503867,1,0,1,1,2,0,1
343,364,383,21,40,0.458770152435355,0.4282163036012329,0.11301354396341176,0.29091898123772403,0.5819133117039763,0.12716770705829966,1,0,3,1,2,0,1
342,289,363,-53,21,0.4506645691879098,0.4310494830937168,0.11828594771837325,0.42012966720385553,0.4729113199630888,0.1069590128330557,1,1,1,3,4,0,0
247,203,226,-44,-21,0.4743003455736094,0.41059631381568595,0.11510334061070468,0.44082854257243553,0.4515564936487629,0.10761496377880177,1,1,1,2,4,1,0
389,494,557,105,168,0.42275627767657475,0.4627942572154102,0.11444946510801499,0.48171290432150077,0.3998624948787707,0.11842460079972834,1,0,1,2,2,0,1
342,467,537,125,195,0.4439858209770933,0.4401339636949013,0.11588021532800562,0.34849313710396274,0.5292197937574017,0.12228706913863531,1,0,1,3,2,0,1
420,370,393,-50,-27,0.4291195818805102,0.46142606991515206,0.10945434820433769,0.3185131496618576,0.5416538016689835,0.13983304866915863,1,1,2,4,4,1,0
284,189,218,-95,-66,0.43475435399698475,0.4541510896248851,0.11109455637813018,0.3955023257057458,0.45808626544948255,0.14641140884477172,1,0,2,3,3,1,0
309,241,289,-68,-20,0.4890998051436293,0.39569612135892857,0.11520407349744238,0.42750753944454684,0.43630609662812,0.13618636392733321,0,0,2,1,0,1,0
314,222,241,-92,-73,0.503337660612302,0.38308353529043815,0.11357880409725966,0.32457209776993995,0.5492311427794655,0.12619675945059464,0,0,1,1,0,1,0
334,237,302,-97,-32,0.4151020870081745,0.4699950089409444,0.11490290405088084,0.4288500886867473,0.4489209505256958,0.12222896078755693,1,0,2,2,2,1,0
297,11,259,-286,-38,0.4447960869387069,0.44200887108444425,0.11319504197684871,0.5046185379764574,0.38497618019578195,0.1104052818277609,1,0,1,1,2,1,0
272,178,206,-94,-66,0.432492898517631,0.4561714741784134,0.11133562730395546,0.5255065156720613,0.357880536321187,0.11661294800675157,0,1,1,2,1,1,0
76,0,69,-76,-7,0.4558970772536817,0.4290597416142352,0.1150431811320831,0.4516834070018832,0.43273801148554003,0.11557858151257672,0,1,1,1,1,1,0
464,394,405,-70,-59,0.4425426852421093,0.4480111878568991,0.1094461269009918,0.4426034719625815,0.4627916957698903,0.09460483226752822,1,1,3,1,4,1,0
251,98,160,-153,-91,0.371206223361271,0.5080963453652934,0.12069743127343548,0.2946667747503719,0.5805908611146245,0.12474236413500375,1,1,1,1,4,1,0
309,246,344,-63,35,0.46894701151643187,0.4132258697955643,0.11782711868800365,0.4446105694750795,0.40055519607211737,0.15483423445280312,0,0,1,1,0,0,0
442,380,403,-62,-39,0.49828998124856677,0.3862848092912616,0.11542520946017173,0.46751444530259684,0.42374244196390143,0.10874311273350201,1,0,3,3,3,1,0
410,232,285,-178,-125,0.4278912695833497,0.4586230701000561,0.11348566031659447,0.312460979070282,0.5577722963504478,0.12976672457927044,0,1,3,1,1,1,0
144,0,101,-144,-43,0.46122847958487967,0.425707202655895,0.11306431775922521,0.5249257202080476,0.36624647063769333,0.10882780915425909,1,1,1,1,4,1,0
78,0,31,-78,-47,0.45620859166647093,0.43121044041718415,0.11258096791634463,0.49912398745000064,0.3807280947977037,0.12014791775229558,1,1,1,1,4,1,0
332,176,309,-156,-23,0.5215814672569948,0.3643175861094493,0.11410094663355598,0.42573403415754335,0.45152748243622254,0.12273848340623382,0,0,6,1,0,1,0
361,216,249,-145,-112,0.4734243115920088,0.41403335885036535,0.11254232955762578,0.48112667511048235,0.4205686634697922,0.09830466141972541,1,0,1,4,2,1,0
264,281,366,17,102,0.41463273426596775,0.47464052267817614,0.110726743055856,0.39789655912991256,0.49045384849060847,0.11164959237947919,1,1,2,1,4,0,1
401,328,411,-73,10,0.5161208815282718,0.36606951083130496,0.11780960764042328,0.35380919085188656,0.49909433132300457,0.1470964778251087,1,0,1,1,2,0,0
300,241,248,-59,-52,0.49628887634961005,0.3886777242883164,0.11503339936207341,0.446683540956648,0.4353794735018986,0.1179369855414533,1,0,1,2,2,1,0
90,0,71,-90,-19,0.45333495062632173,0.4342338217582681,0.11243122761541019,0.478540749039012,0.4141021139517952,0.10735713700919275,0,1,1,1,1,1,0
169,181,230,12,61,0.42994654322033293,0.4554552396985306,0.11459821708113622,0.4637216337135192,0.4165551402781946,0.1197232260082858,0,1,3,2,1,0,1
343,219,243,-124,-100,0.48407685163862324,0.4024418165910383,0.11348133177033863,0.3425015549118412,0.5262098066330219,0.13128863845513675,0,0,1,1,0,1,0
335,213,299,-122,-36,0.36407096208009604,0.5245191783577359,0.11140985956216815,0.4311185219587835,0.42929535679277364,0.13958612124844316,0,0,3,1,0,1,0
251,130,266,-121,15,0.41298543225716616,0.4740623773740905,0.11295219036874324,0.49001282336495555,0.3987756350119859,0.1112115416230585,1,0,3,1,2,0,0
308,193,217,-115,-91,0.46532420691619003,0.4244087838556141,0.1102670092281958,0.43009855004853137,0.45841284834197854,0.11148860160948995,0,0,1,1,0,1,0
379,280,335,-99,-44,0.40185315426421714,0.4884943550504975,0.10965249068528542,0.4280089758228904,0.4587931572396,0.11319786693750947,0,0,2,2,0,1,0
379,412,465,33,86,0.46772138321963075,0.41722271209881095,0.11505590468155823,0.4906443784122099,0.38959726626949115,0.11975835531829866,1,0,1,1,2,0,1
315,239,282,-76,-33,0.4913480704320592,0.3983314446022853,0.11032048496565554,0.24655462568885586,0.5975811591246473,0.15586421518649696,0,0,4,1,0,1,0
320,228,298,-92,-22,0.48287379252069396,0.4029470795090234,0.11417912797028298,0.5035328713825656,0.38844256508704256,0.10802456353039169,1,1,1,2,4,1,0
317,270,282,-47,-35,0.45314824094048195,0.431080674876738,0.11577108418278015,0.41974029880510955,0.46830719203163257,0.11195250916325793,0,1,1,1,1,1,0
401,242,274,-159,-127,0.4374944122805439,0.4517332974548486,0.11077229026460726,0.47762402546047106,0.4134220326541411,0.10895394188538764,0,0,2,1,0,1,0
300,192,431,-108,131,0.4371428594610821,0.4521967249032571,0.11066041563566145,0.3533822071124593,0.5271329827776434,0.11948481010989696,0,0,1,1,0,0,0
291,84,141,-207,-150,0.465497212125234,0.4192060949508834,0.1152966929238824,0.4827305586235408,0.40105992895763076,0.11620951241882845,1,1,1,1,4,1,0
402,430,562,28,160,0.47510626566374825,0.4092997080888108,0.11559402624744086,0.4787276008065041,0.39748418478442504,0.12378821440907094,0,0,3,2,0,0,1
302,235,241,-67,-61,0.4463869422990118,0.4407132123813736,0.11289984531961463,0.46210670937338244,0.4284146560912827,0.10947863453533456,1,0,2,1,2,1,0
561,370,433,-191,-128,0.46669637429157484,0.41512862608612844,0.11817499962229673,0.34248699149016687,0.513796970634188,0.14371603787564521,0,0,3,1,0,1,0
440,281,310,-159,-130,0.3477919001520485,0.5375558676978219,0.11465223215012897,0.3770648642727369,0.501370411423145,0.12156472430411773,1,0,1,1,3,1,0
377,241,401,-136,24,0.47370331420474365,0.4129468803321223,0.11334980546313407,0.405779073579385,0.45818152995814726,0.1360393964624676,1,0,2,1,2,0,0
560,410,535,-150,-25,0.43389693198360124,0.4534293242827614,0.11267374373363757,0.49465483535810606,0.3977732124825358,0.107571952159358,1,1,6,4,4,1,0
288,228,273,-60,-15,0.40918767324678795,0.4689440242412843,0.12186830251192739,0.42641398711308226,0.44687582254199576,0.12671019034492212,0,0,1,1,0,1,0
493,397,429,-96,-64,0.4886296573617711,0.4000184979422928,0.11135184469593609,0.421417709779241,0.4549068884903866,0.12367540173037238,1,0,1,1,2,1,0
409,343,426,-66,17,0.4448241692889716,0.44517276042063364,0.1100030702903948,0.4003298114263872,0.4733374847911525,0.12633270378246036,1,0,1,1,2,0,0
329,312,348,-17,19,0.46173404828893083,0.4255780541072481,0.11268789760382115,0.4515561674641495,0.44483203236207436,0.10361180017377616,1,0,1,1,2,0,0
261,225,355,-36,94,0.39890436002330526,0.48094634901275285,0.12014929096394186,0.32573018886098754,0.5358405509580242,0.1384292601809881,1,0,4,1,2,0,0
246,203,314,-43,68,0.45587803285449147,0.43143367243621583,0.11268829470929273,0.4167711500364946,0.448938958504931,0.13428989145857426,1,0,1,2,2,0,0
290,144,221,-146,-69,0.4588586695691217,0.42530747122475293,0.11583385920612552,0.4914380820949266,0.4057498861148367,0.10281203179023642,1,1,1,1,4,1,0
128,83,154,-45,26,0.42986893516888586,0.45634052481553206,0.11379054001558199,0.5127044062596886,0.37320692198870986,0.11408867175160137,1,1,1,1,4,0,0
580,452,668,-128,88,0.5610589875595985,0.32321490378378104,0.11572610865662036,0.41413968093053094,0.4628959743190674,0.12296434475040162,0,0,2,1,0,0,0
346,259,318,-87,-28,0.5100221259038783,0.37708087259974027,0.11289700149638156,0.5420624626356223,0.36937064551189536,0.08856689185248218,1,0,1,1,2,1,0
415,289,349,-126,-66,0.5432911781195706,0.3424950076613122,0.11421381421911705,0.5504077221987053,0.3435336108015105,0.10605866699978447,0,0,1,2,0,1,0
290,238,304,-52,14,0.4196539645398401,0.4716359748267793,0.10871006063338057,0.3656637318487336,0.47704988126633147,0.15728638688493507,1,0,3,2,2,0,0
388,421,437,33,49,0.4214644160941099,0.46575918827643586,0.11277639562945417,0.4301013033551784,0.45124394439247584,0.11865475225234624,0,0,1,2,0,0,1
247,218,236,-29,-11,0.4431308002576896,0.4439916509538804,0.11287754878843001,0.5061348328367977,0.3915264357716035,0.10233873139159874,0,1,1,2,1,1,0
351,319,336,-32,-15,0.4205343993290882,0.4652636819348064,0.11420191873610559,0.31231341583920835,0.5581717735564993,0.12951481060429218,1,1,1,2,4,1,0
143,0,210,-143,67,0.4434668819405945,0.4431691990086327,0.11336391905077274,0.4781324347382351,0.4136886168179674,0.10817894844379734,1,1,1,1,4,0,0
372,115,346,-257,-26,0.41116123943300925,0.46771046700014546,0.12112829356684539,0.3289098657930284,0.5379393853318921,0.1331507488750795,1,0,1,1,2,1,0
471,421,444,-50,-27,0.49313560304901666,0.3888176764701558,0.11804672048082746,0.47118511447508127,0.41167870942576745,0.1171361760991513,1,1,3,1,4,1,0
312,266,277,-46,-35,0.4572997695552765,0.42342195501902186,0.11927827542570192,0.40004090751532834,0.4919801183103986,0.10797897417427331,0,1,4,3,1,1,0
351,364,380,13,29,0.4056609913137054,0.4776955686966557,0.11664343998963875,0.40341661226294556,0.47843571949035446,0.11814766824669995,1,0,2,3,2,0,1
377,302,388,-75,11,0.4449388465176394,0.44145629920457524,0.11360485427778537,0.4488913629779275,0.4311564418301906,0.11995219519188159,1,0,1,1,2,0,0
430,205,415,-225,-15,0.4275467867317766,0.4581088908828457,0.11434432238537755,0.3356244175036467,0.5456492583148018,0.11872632418155137,1,0,1,1,2,1,0
133,111,151,-22,18,0.48373884453143023,0.4054605126374264,0.1108006428311435,0.45689221624249404,0.4329976758963026,0.11011010786120337,1,0,1,2,2,0,0
254,154,325,-100,71,0.4730979865549462,0.41253627686679245,0.11436573657826145,0.4266694458321581,0.46439243306870315,0.10893812109913892,1,1,1,2,4,0,0
397,304,328,-93,-69,0.43246833254447314,0.44914952461624114,0.11838214283928579,0.3031979584579577,0.5761413522722092,0.12066068926983312,0,0,1,2,0,1,0
308,213,295,-95,-13,0.4121775860200832,0.4765724370314273,0.11124997694848965,0.3741257493892486,0.5071033003566603,0.11877095025409118,1,1,1,2,4,1,0
280,188,211,-92,-69,0.48325994086752294,0.4019889373402925,0.11475112179218407,0.4493362451614333,0.4203949752497426,0.1302687795888241,0,1,1,1,1,1,0
250,164,215,-86,-35,0.42557733828438515,0.46239635634476667,0.11202630537084829,0.503015321094332,0.37746604060937444,0.11951863829629346,0,0,3,1,0,1,0
246,142,215,-104,-31,0.41373418985268856,0.4734310273091951,0.11283478283811617,0.2591785773423699,0.6135870876844182,0.127234334973212,0,1,1,1,1,1,0
190,156,176,-34,-14,0.46155964966850216,0.4271947299924364,0.11124562033906168,0.4219418732612287,0.4719327709158777,0.10612535582289356,1,0,1,1,2,1,0
257,90,204,-167,-53,0.44028258516476454,0.4467530320151613,0.11296438282007422,0.4990242749849101,0.39297411838840446,0.10800160662668541,1,0,1,1,2,1,0
305,144,248,-161,-57,0.4508401481661655,0.4327677622768551,0.1163920895569795,0.4915001263957063,0.39315768355542285,0.11534219004887068,0,0,4,2,0,1,0
273,112,223,-161,-50,0.47945231144274575,0.4034966076010192,0.1170510809562348,0.47879840292611675,0.4138765157473119,0.10732508132657151,1,0,1,1,2,1,0
344,326,370,-18,26,0.4109200087045298,0.4757306468830235,0.11334934441244647,0.34372997504271485,0.525691757125445,0.1305782678318402,0,1,2,3,1,0,0
255,123,210,-132,-45,0.4369695019691497,0.44973725606837656,0.11329324196247377,0.4512964070961555,0.43000484420457846,0.11869874869926589,1,1,1,1,4,1,0
390,336,366,-54,-24,0.45377575455956537,0.4318993073315085,0.114324938108926,0.4319262446026701,0.430341334724545,0.1377324206727849,0,1,3,2,1,1,0
376,211,254,-165,-122,0.4027990135015238,0.48717782495623735,0.11002316154223868,0.47563428815961817,0.41495428030762044,0.10941143153276152,1,1,1,3,4,1,0
266,147,217,-119,-49,0.45125891733331486,0.4347558550452107,0.11398522762147478,0.41391068462651176,0.4818426334698772,0.10424668190361093,0,0,1,1,0,1,0
464,324,400,-140,-64,0.4097104268179344,0.4748636618262572,0.11542591135580849,0.43761561507218977,0.44868333621833656,0.11370104870947355,0,0,2,1,0,1,0
330,171,251,-159,-79,0.41651278276930653,0.4661328011954684,0.11735441603522523,0.4395352789383168,0.4430907406993855,0.11737398036229779,0,0,1,3,0,1,0
594,502,640,-92,46,0.4486621288354664,0.43936700776529175,0.11197086339924182,0.3556024544161239,0.5303777354084688,0.11401981017540735,1,0,1,2,2,0,0
321,66,102,-255,-219,0.48274969090382736,0.3971384034015185,0.1201119056946542,0.5077631075258707,0.376795620257869,0.11544127221626016,0,0,1,1,0,1,0
260,222,242,-38,-18,0.4492683562495846,0.4381415381220579,0.11259010562835743,0.48239971979397545,0.3893677354415465,0.12823254476447815,1,0,2,1,2,1,0
321,232,291,-89,-30,0.46055606079483,0.4231773098584295,0.11626662934674069,0.47307496010627104,0.41121113001735576,0.11571390987637337,0,1,1,1,1,1,0
342,260,305,-82,-37,0.4458618793043526,0.44025624683692294,0.11388187385872434,0.44932931295651196,0.4543760626177947,0.09629462442569327,1,0,1,2,3,1,0
351,213,249,-138,-102,0.45439119634620456,0.43279323150657695,0.11281557214721864,0.36993278797551804,0.51016446938923,0.11990274263525211,0,0,2,1,0,1,0
398,24,103,-374,-295,0.460060120253063,0.4271466749072977,0.11279320483963948,0.33355159840272897,0.5502056584846549,0.11624274311261608,0,0,1,1,0,1,0
307,342,377,35,70,0.47571517167198196,0.40350818746085265,0.12077664086716555,0.3139440767427922,0.563226888163815,0.12282903509339295,1,0,3,3,2,0,1
280,197,302,-83,22,0.5295157091188851,0.3560075332637373,0.11447675761737769,0.5011297968822783,0.39188806906946294,0.10698213404825864,1,1,1,1,4,0,0
133,18,52,-115,-81,0.4352923749152323,0.4517550302095391,0.11295259487522881,0.4693803328447602,0.41393128485641345,0.1166883822988265,1,1,1,1,4,1,0
301,324,345,23,44,0.49433800381252,0.3874924750104541,0.11816952117702571,0.4962742259718142,0.397529417512206,0.10619635651597982,1,0,1,1,2,0,1
382,402,423,20,41,0.49519418607077853,0.386258481656362,0.1185473322728594,0.44932436179933205,0.415432502632032,0.13524313556863593,1,0,3,1,2,0,1
277,298,322,21,45,0.4304822176084447,0.4533137560342537,0.11620402635730177,0.4087544167550981,0.453737536956883,0.13750804628801902,1,1,4,1,4,0,1
333,280,352,-53,19,0.5199120075711183,0.3622823724272737,0.11780562000160788,0.32902387735993444,0.5191869345552308,0.15178918808483502,1,1,1,1,4,0,0
184,133,151,-51,-33,0.43519618344705574,0.4538422942115279,0.11096152234141628,0.4961404003157752,0.39832327278600077,0.10553632689822404,1,1,3,4,4,1,0
322,162,249,-160,-73,0.4339369370464966,0.4544467567126913,0.11161630624081213,0.4225132876877491,0.4587580242861155,0.11872868802613548,1,0,2,1,2,1,0
293,206,270,-87,-23,0.466615656749517,0.4198070940408731,0.11357724920961,0.4760411477474818,0.41241207436638594,0.11154677788613211,1,1,1,3,4,1,0
311,205,292,-106,-19,0.46115070821149257,0.4253375643970946,0.11351172739141276,0.4760490082179071,0.4114041765273634,0.11254681525472952,0,0,1,1,0,1,0
466,369,498,-97,32,0.5256010453285812,0.3625855108858111,0.1118134437856077,0.3476996934902413,0.5404527532301124,0.11184755327964636,1,1,1,1,4,0,0
450,270,335,-180,-115,0.5068488821922004,0.37845868870495813,0.11469242910284136,0.3898612481142827,0.5015040848926089,0.1086346669931084,1,0,1,3,3,1,0
456,470,487,14,31,0.47996143930755836,0.40281690485281835,0.11722165583962336,0.26622210109034,0.5800916134636145,0.1536862854460454,1,0,1,3,2,0,1
81,129,144,48,63,0.4358591853711392,0.45183144238034073,0.11230937224851999,0.49220887819158776,0.4019010989723824,0.10589002283602977,0,0,1,2,0,0,1
339,301,382,-38,43,0.43267049728272633,0.45607951574441347,0.11124998697286026,0.17300733068336444,0.682193272344754,0.1447993969718814,1,1,1,2,4,0,0
204,101,176,-103,-28,0.4447960869387069,0.44200887108444425,0.11319504197684871,0.5046185379764574,0.38497618019578195,0.1104052818277609,1,0,2,1,2,1,0
136,158,172,22,36,0.4447960869387069,0.44200887108444425,0.11319504197684871,0.5046185379764574,0.38497618019578195,0.1104052818277609,0,1,1,1,1,0,1
324,245,279,-79,-45,0.422408199070755,0.46618836519808804,0.11140343573115723,0.41863980601944056,0.4676211421307037,0.11373905184985562,0,0,1,1,0,1,0
474,526,575,52,101,0.4618071452148157,0.4183524117764655,0.11984044300871857,0.4219734866352451,0.4708379939546719,0.10718851941008295,0,0,3,3,0,0,1
291,210,235,-81,-56,0.41382524012909117,0.4778801874875987,0.10829457238331011,0.4273658283759743,0.46083699313500004,0.11179717848902584,0,1,2,2,1,1,0
273,300,327,27,54,0.42671158635526313,0.45753273702982655,0.11575567661491032,0.5406861203349231,0.3602635037179946,0.09905037594708241,0,0,1,1,0,0,1
308,13,258,-295,-50,0.4447960869387069,0.44200887108444425,0.11319504197684871,0.5046185379764574,0.38497618019578195,0.1104052818277609,0,1,1,1,1,1,0
283,232,301,-51,18,0.45597184957079734,0.4318791317788983,0.11214901865030424,0.5116108835886926,0.3757526339727803,0.11263648243852727,1,0,1,3,2,0,0
296,233,261,-63,-35,0.4528551788501115,0.43374376498264733,0.11340105616724123,0.45199965150217847,0.43315318687699106,0.11484716162083054,1,1,2,1,4,1,0
583,479,510,-104,-73,0.44116825423721956,0.44355662384730754,0.11527512191547275,0.3886943493546859,0.47466271425916357,0.13664293638615052,0,0,2,3,0,1,0
402,333,361,-69,-41,0.5721810947872579,0.3104074599840225,0.11741144522872,0.4957939765794665,0.4178813774173316,0.08632464600320165,0,1,1,1,1,1,0
430,281,314,-149,-116,0.47913822713684207,0.40787164370542844,0.1129901291577295,0.46258729485785954,0.42606942976677914,0.11134327537536094,1,1,4,1,4,1,0
303,158,218,-145,-85,0.4620265720111077,0.427380858152866,0.11059256983602629,0.40868227014095193,0.4747244375709177,0.11659329228813077,1,1,2,2,4,1,0
403,284,313,-119,-90,0.467861196707154,0.40983546062067655,0.12230334267216965,0.37238457595968766,0.506687011739768,0.12092841230054463,1,0,1,1,2,1,0
342,194,255,-148,-87,0.4791287192955437,0.4041035859325299,0.11676769477192647,0.38484178891216125,0.500311650536044,0.1148465605517949,0,1,1,1,1,1,0
232,268,292,36,60,0.44513239565724394,0.43717163039339113,0.1176959739493649,0.49781355277583744,0.4003618078182731,0.10182463940588939,1,0,1,1,2,0,1
357,293,306,-64,-51,0.476692566122418,0.41138615100262454,0.11192128287495738,0.41638377438306867,0.44101437009284644,0.14260185552408466,0,0,1,2,0,1,0
199,103,134,-96,-65,0.4421412447303709,0.4395257765300531,0.11833297873957573,0.34298164249738405,0.5432209915568775,0.11379736594573854,0,1,2,2,1,1,0
398,257,370,-141,-28,0.45433159964483666,0.4283012369685371,0.1173671633866264,0.5073709452668443,0.3595378560313122,0.1330911987018434,1,0,2,1,2,1,0
350,261,339,-89,-11,0.4642501849907135,0.4185461672339174,0.11720364777536879,0.4698115129642868,0.4026608543660335,0.12752763266967956,1,1,1,1,4,1,0
310,171,252,-139,-58,0.4437259582957123,0.44307185538668764,0.11320218631760011,0.49291989693716487,0.38109190748734445,0.12598819557549065,1,0,1,2,2,1,0
118,134,238,16,120,0.4448811972849147,0.4415014857600341,0.11361731695505091,0.4675836634932571,0.4239948059252432,0.10842153058149973,1,0,2,1,2,0,1
330,169,258,-161,-72,0.4601791548784493,0.43093680100454623,0.10888404411700432,0.30377468176033146,0.5688313656225269,0.12739395261714176,0,0,2,1,0,1,0
305,412,422,107,117,0.4514296857374605,0.4333138002087544,0.11525651405378515,0.44448693458788147,0.4440868260933767,0.1114262393187416,1,0,2,2,2,0,1
297,233,261,-64,-36,0.4624027855961124,0.42692521526033833,0.110671999143549,0.3885818387479751,0.47915017586847036,0.13226798538355428,1,0,1,1,2,1,0
277,235,250,-42,-27,0.48876425098728654,0.3961402788311086,0.11509547018160492,0.390608712822332,0.49378482431486326,0.11560646286280496,1,0,1,1,2,1,0
306,338,360,32,54,0.4636932535011658,0.42598388531666126,0.11032286118217298,0.38519184993783795,0.5182325331768073,0.09657561688535503,1,0,2,1,2,0,1
392,282,361,-110,-31,0.3970196187263774,0.48940553404646625,0.11357484722715619,0.30147988151129107,0.5516480001800186,0.1468721183086903,0,1,1,2,1,1,0
278,225,256,-53,-22,0.4225632820423814,0.46658448243288975,0.11085223552472892,0.4481056221985868,0.4395605902586969,0.11233378754271625,1,1,3,3,4,1,0
315,263,297,-52,-18,0.4614150994222555,0.4222018331887518,0.11638306738899248,0.5378065219763972,0.3546126982053201,0.10758077981828269,0,1,1,1,1,1,0
159,186,220,27,61,0.4529023362312677,0.4338701492099943,0.1132275145587382,0.5117478571227981,0.37300402599815585,0.11524811687904585,1,1,1,1,4,0,1
429,336,466,-93,37,0.40595627512548216,0.4833727218146639,0.11067100305985411,0.29238647734083517,0.5781734847120866,0.12944003794707823,1,0,1,3,2,0,0
233,301,312,68,79,0.4778510323542324,0.4067344669368485,0.11541450070891902,0.5047155574005688,0.38312152717547426,0.11216291542395694,1,1,1,1,4,0,1
282,178,241,-104,-41,0.4384565008025067,0.4488886450669741,0.11265485413051929,0.4854391548464939,0.40399517857996453,0.1105656665735416,1,0,1,2,3,1,0
270,241,260,-29,-10,0.43825581839283545,0.44745933438053337,0.11428484722663104,0.4602383028215301,0.43540567438571826,0.10435602279275144,1,0,2,2,2,1,0
376,333,389,-43,13,0.3961404027689865,0.4899571163760313,0.11390248085498234,0.4041741216582903,0.46798262997210305,0.12784324836960687,1,0,1,1,2,0,0
267,237,253,-30,-14,0.48592722678592903,0.39891491643937205,0.11515785677469893,0.4576296175914241,0.40883552353103936,0.13353485887753683,1,0,1,2,2,1,0
419,333,357,-86,-62,0.48827919442429607,0.3950093364689045,0.11671146910679941,0.40580136557589797,0.47035168351514045,0.12384695090896164,0,0,1,1,0,1,0
328,333,364,5,36,0.43425757647940083,0.45424771819245513,0.11149470532814415,0.4234996437783289,0.4525880295144532,0.12391232670721784,1,0,1,4,3,0,1
512,379,420,-133,-92,0.48089603169202144,0.4055982591488583,0.11350570915911999,0.3671832966827802,0.5231483576565851,0.10966834566063469,0,0,1,2,0,1,0
332,225,232,-107,-100,0.44561478394416904,0.44071345842739335,0.11367175762843772,0.43388131781010925,0.4505287400688348,0.11558994212105564,1,0,2,2,2,1,0
292,309,433,17,141,0.39995241144241633,0.4889595294935239,0.11108805906405979,0.26928300822034235,0.5842070559937658,0.146509935785892,1,1,1,1,4,0,1
351,51,329,-300,-22,0.485403384167881,0.40131595215042914,0.1132806636816897,0.49586342151021234,0.3912779560565928,0.11285862243319467,0,0,1,1,0,1,0
430,244,314,-186,-116,0.44109478389538176,0.44304706417151213,0.11585815193310618,0.3903464492439703,0.47780007263721136,0.13185347811881862,1,1,1,1,4,1,0
249,259,338,10,89,0.440678101235022,0.4396965095285279,0.11962538923645018,0.3442045040605504,0.5310576327814358,0.1247378631580136,0,1,3,2,1,0,1
390,327,348,-63,-42,0.4285833994965408,0.4601608864971448,0.11125571400631437,0.45657523415111795,0.422824054713454,0.12060071113542803,1,0,3,2,2,1,0
297,346,431,49,134,0.622723924753977,0.25705808122133816,0.12021799402468453,0.4619628885823413,0.42870618293364765,0.1093309284840112,1,1,2,1,4,0,1
327,181,247,-146,-80,0.46501116060115044,0.42008044625085195,0.11490839314799757,0.379512305311273,0.4983897874448098,0.12209790724391724,0,1,1,3,1,1,0
343,244,287,-99,-56,0.4313495650972447,0.45802622945294436,0.11062420544981108,0.38134563540952354,0.49931266866648816,0.11934169592398838,1,0,4,2,2,1,0
388,341,400,-47,12,0.548109205892507,0.3279813273831938,0.12390946672429934,0.296030850672394,0.576721348383963,0.12724780094364332,1,0,1,4,2,0,0
194,127,182,-67,-12,0.4641912016586805,0.42266369535727116,0.11314510298404828,0.38041577288804385,0.4961322924875746,0.1234519346243817,0,1,2,1,1,1,0
238,124,135,-114,-103,0.4447960869387069,0.44200887108444425,0.11319504197684871,0.5046185379764574,0.38497618019578195,0.1104052818277609,1,1,1,3,4,1,0
433,154,354,-279,-79,0.4514789086693498,0.4405932583711455,0.10792783295950462,0.4588387687268594,0.40827735443642943,0.13288387683671118,0,0,1,1,0,1,0
387,232,352,-155,-35,0.4736080081764247,0.4122439493072393,0.1141480425163357,0.5226189798590956,0.36597228929370246,0.11140873084720196,0,1,3,1,1,1,0
346,0,210,-346,-136,0.4447960869387069,0.44200887108444425,0.11319504197684871,0.5046185379764574,0.38497618019578195,0.1104052818277609,1,0,1,1,3,1,0
315,240,287,-75,-28,0.5010354143609874,0.3856166316274246,0.11334795401158768,0.49176432268765125,0.3925533561193341,0.11568232119301439,1,0,1,1,2,1,0
460,309,347,-151,-113,0.5165794424950193,0.36674160817551377,0.11667894932946675,0.4636674962882046,0.4400257043684383,0.09630679934335706,0,1,2,2,1,1,0
297,192,269,-105,-28,0.373927912744076,0.5080863303246846,0.11798575693123968,0.38820154045682387,0.49455620528968297,0.11724225425349304,0,0,2,1,0,1,0
276,150,240,-126,-36,0.45224047611519835,0.43512692985543866,0.11263259402936272,0.5251447566747053,0.35156914685286994,0.12328609647242499,1,0,1,1,2,1,0
417,349,466,-68,49,0.4479870177136825,0.43970016103239634,0.1123128212539213,0.2864727420261048,0.585105980485759,0.12842127748813623,1,0,1,2,2,0,0
233,290,322,57,89,0.46639929330110835,0.41631461600558795,0.1172860906933037,0.3804016672723733,0.49311563001292696,0.12648270271469972,1,0,3,1,2,0,1
374,316,416,-58,42,0.39909292546285513,0.4915370796458868,0.10936999489125834,0.4090944121336171,0.48050615709412486,0.1103994307722578,1,0,2,1,2,0,0
364,211,279,-153,-85,0.519162598155841,0.368232910199269,0.11260449164488998,0.4975761455322691,0.37975465300343964,0.12266920146429126,0,0,1,1,0,1,0
361,286,333,-75,-28,0.5024641873249042,0.38128492758443705,0.11625088509065906,0.4480629307360324,0.4291827721340623,0.12275429712990532,1,1,1,2,4,1,0
660,547,589,-113,-71,0.3427207689482873,0.5438746548632207,0.11340457618849205,0.3639958022314641,0.4975071269344794,0.13849707083405657,0,0,1,3,0,1,0
282,192,266,-90,-16,0.4554480849797432,0.4309603336433032,0.11359158137695365,0.3923543282854596,0.48871568446377456,0.118929987250766,0,1,1,1,1,1,0
273,224,259,-49,-14,0.4850809233667933,0.4009760924132045,0.11394298422000239,0.46309897927143606,0.417354975515636,0.11954604521292783,1,0,4,1,3,1,0
252,198,283,-54,31,0.3444393917311625,0.5403665814964825,0.11519402677235487,0.44566226864224767,0.43933454271845784,0.11500318863929468,1,0,1,2,2,0,0
326,303,361,-23,35,0.49561541720711,0.3898086917158676,0.11457589107702232,0.4260386888597461,0.4571385916274602,0.11682271951279348,1,0,1,3,2,0,0
323,256,290,-67,-33,0.467046097640397,0.42125427735986615,0.11169962499973672,0.3947445933160643,0.5008170341559963,0.1044383725279392,1,0,1,3,3,1,0
325,174,202,-151,-123,0.5090191307142657,0.3780477965175234,0.11293307276821074,0.4395817027928567,0.46206976749892636,0.0983485297082168,0,0,1,1,0,1,0
347,294,320,-53,-27,0.40959798474028103,0.47731185529355163,0.11309015996616718,0.4565162648736727,0.4406583015605172,0.10282543356581014,1,0,3,1,3,1,0
472,490,497,18,25,0.4820975454694772,0.40118005200988305,0.1167224025206396,0.3110558608849615,0.5648207630543916,0.12412337606064652,1,0,1,3,2,0,1
306,207,226,-99,-80,0.4598906093614488,0.42667249841195465,0.11343689222659654,0.4521159701961872,0.43181140810167956,0.1160726217021329,0,0,2,3,0,1,0
369,276,406,-93,37,0.48735048249249396,0.4040152488996783,0.108634268607828,0.1787388699864785,0.6929918571865488,0.12826927282697284,1,0,1,1,2,0,0
399,359,421,-40,22,0.4276908099997163,0.459819313031079,0.11248987696920483,0.3305015066359076,0.5229945678856844,0.14650392547840843,1,0,2,3,2,0,0
182,186,225,4,43,0.484720741332705,0.3998048828074688,0.11547437585982596,0.5362786031214634,0.35273337905858837,0.11098801781994844,1,1,1,1,4,0,1
238,186,270,-52,32,0.4857273140593189,0.39820279336765496,0.116069892573026,0.47344337681399884,0.3978060874257653,0.12875053576023585,1,1,1,2,4,0,0
281,177,237,-104,-44,0.4391120668550509,0.44788113359482984,0.11300679955011922,0.4890224188469417,0.3914610837421086,0.11951649741095004,1,1,1,1,4,1,0
317,274,371,-43,54,0.4578338591264527,0.4321034706462436,0.11006267022730354,0.4285476059323883,0.45168787539754296,0.11976451867006857,1,0,1,3,2,0,0
282,349,434,67,152,0.40806855608355613,0.48175373189115905,0.11017771202528467,0.5176518076903793,0.3752399312931051,0.10710826101651554,1,0,2,1,2,0,1
394,312,331,-82,-63,0.47565564308929364,0.4063361530554686,0.11800820385523775,0.5231878674125409,0.3788668005668733,0.09794533202058574,1,0,2,1,2,1,0
283,39,133,-244,-150,0.44810865713094966,0.438386574813321,0.1135047680557293,0.4533597929532224,0.4340930728891841,0.1125471341575933,1,1,1,1,4,1,0
261,169,188,-92,-73,0.4474761720932768,0.4391772643351444,0.11334656357157871,0.43749031874046945,0.43494683494204683,0.12756284631748357,0,0,1,1,0,1,0
63,0,55,-63,-8,0.47299081547847316,0.4132022857981782,0.11380689872334836,0.4940582508143482,0.3937510697754788,0.11219067941017297,0,1,1,1,1,1,0
547,401,522,-146,-25,0.4543774133223695,0.4284247935711297,0.11719779310650076,0.3111340042408554,0.5581957592547535,0.13067023650439136,1,1,1,1,4,1,0
356,318,338,-38,-18,0.4334698104692163,0.45172993048309384,0.11480025904768967,0.4250609089189783,0.4566103088523708,0.11832878222865077,0,0,2,2,0,1,0
299,228,281,-71,-18,0.4696901574622584,0.41393032044174816,0.11637952209599366,0.4985556739584363,0.39543495237562526,0.10600937366593821,1,0,2,2,2,1,0
372,263,301,-109,-71,0.4952235135080333,0.39394399492365667,0.11083249156830961,0.4720295927922921,0.4209743916804962,0.10699601552721148,0,0,1,1,0,1,0
449,193,348,-256,-101,0.3981347435341226,0.48878104655309834,0.11308420991277926,0.3350138913015745,0.5481649621834382,0.11682114651498719,0,0,1,1,0,1,0
328,265,310,-63,-18,0.46516350447155397,0.4229103265899428,0.11192616893850346,0.4680488827127697,0.40656292678717876,0.12538819050005146,1,1,1,1,4,1,0
311,191,283,-120,-28,0.4917633021117169,0.39524447864740536,0.11299221924087768,0.4071120527663688,0.4780844704740139,0.114803476759617,0,0,3,1,0,1,0
239,248,290,9,51,0.44471289757928545,0.43974536446199725,0.1155417379587173,0.3984910794693144,0.4760982356972892,0.1254106848333964,1,1,1,3,4,0,1
285,304,335,19,50,0.5186629025889233,0.36645390532177435,0.11488319208930227,0.49491290520488074,0.3980774424937019,0.10700965230141737,1,0,1,1,2,0,1
371,376,388,5,17,0.408429523855419,0.4779058949945989,0.11366458114998189,0.4375882748726024,0.44717736834014654,0.11523435678725133,1,0,5,2,3,0,1
276,138,203,-138,-73,0.4624768398406702,0.42321360794414364,0.11430955221518607,0.4942970462001796,0.4000824530829637,0.10562050071685658,0,0,1,1,0,1,0
288,251,264,-37,-24,0.41290909634113016,0.4761869553115642,0.1109039483473058,0.41467992509198537,0.46559923467306075,0.11972084023495384,1,1,2,2,4,1,0
341,282,319,-59,-22,0.44802501117874327,0.4382714380849124,0.1137035507363442,0.4439058636771884,0.435493805564893,0.12060033075791876,0,1,3,1,1,1,0
255,266,287,11,32,0.4732629221848878,0.4089850576073187,0.11775202020779373,0.3035368814206869,0.578520742563145,0.11794237601616839,1,1,2,2,4,0,1
270,143,226,-127,-44,0.450142436816089,0.43627963647313744,0.11357792671077353,0.4091407372819186,0.489189412786934,0.10166984993114737,1,1,1,1,4,1,0
291,215,272,-76,-19,0.5593806147510395,0.32196520468043693,0.11865418056852367,0.5480227217162159,0.3618661047588717,0.09011117352491242,0,1,1,1,1,1,0
267,110,141,-157,-126,0.4233646398325648,0.4632282630998763,0.1134070970675589,0.4558489204958769,0.4352128936609068,0.10893818584321627,1,0,1,1,2,1,0
414,264,371,-150,-43,0.47109548502322524,0.4181974983426635,0.11070701663411095,0.5495987738856328,0.34612074129222475,0.10428048482214237,1,0,1,1,3,1,0
501,399,449,-102,-52,0.4447960869387069,0.44200887108444425,0.11319504197684871,0.5046185379764574,0.38497618019578195,0.1104052818277609,1,0,1,2,3,1,0
275,200,257,-75,-18,0.4576944833883039,0.42686880660370213,0.11543671000799366,0.45697431007757816,0.42991530129482325,0.1131103886275983,1,0,1,3,2,1,0
465,213,263,-252,-202,0.44086527556737204,0.4444732391857504,0.11466148524687747,0.33030681946239027,0.5567591514082808,0.11293402912932894,1,1,1,2,4,1,0
580,564,601,-16,21,0.3839131394358369,0.5072627393000783,0.10882412126408493,0.462616276829838,0.43656003064821003,0.10082369252195197,0,1,1,2,1,0,0
236,163,249,-73,13,0.4037641025661887,0.4780848170496555,0.11815108038415575,0.40872931504418697,0.47010261723590135,0.12116806771991154,1,0,2,2,2,0,0
276,222,257,-54,-19,0.4820525775995981,0.40497487443383334,0.11297254796656904,0.4782718529930804,0.42102964381284175,0.10069850319407761,1,1,1,1,4,1,0
342,195,242,-147,-100,0.4628735548594983,0.42539782670011816,0.11172861844038373,0.5563603162997446,0.3394420412220342,0.10419764247822116,0,0,1,1,0,1,0
256,196,229,-60,-27,0.4535151308027167,0.43094201514612346,0.11554285405115985,0.5096115538259114,0.37995973671032174,0.11042870946376664,0,0,1,1,0,1,0
239,182,270,-57,31,0.5359404980422982,0.3472995066385359,0.11675999531916592,0.43537232619925303,0.4387491384268769,0.12587853537387028,1,0,3,1,2,0,0
267,195,217,-72,-50,0.4461793838748244,0.4415843979839616,0.11223621814121405,0.5258077988419291,0.3522094079995323,0.12198279315853873,0,0,3,1,0,1,0
325,246,310,-79,-15,0.4586374610169814,0.43009566754280537,0.1112668714402135,0.456570930556203,0.4201609427274077,0.12326812671638923,0,0,3,1,0,1,0
340,93,324,-247,-16,0.5222856706721337,0.3623345429919215,0.11537978633594449,0.4078680697706036,0.4697149445833255,0.12241698564607115,0,1,1,1,1,1,0
311,175,277,-136,-34,0.46572869580707954,0.41843533873207844,0.11583596546084189,0.527967860331403,0.3625554432697117,0.10947669639888558,1,0,1,1,2,1,0
292,339,373,47,81,0.4714877035365574,0.41049523470222365,0.1180170617612189,0.4194179332699399,0.4601043695312376,0.12047769719882263,1,0,1,2,2,0,1
280,187,200,-93,-80,0.4288834236774786,0.45405630227477184,0.11706027404774946,0.468962980892007,0.41350950492813343,0.1175275141798594,0,0,1,2,0,1,0
342,299,312,-43,-30,0.420001764072835,0.46451885432080703,0.11547938160635778,0.35680504369118354,0.5410157799786921,0.10217917633012417,1,1,1,2,4,1,0
424,318,338,-106,-86,0.49961956539348673,0.38447445857970325,0.11590597602680987,0.3785771027850945,0.48028638477342167,0.1411365124414838,1,0,1,1,2,1,0
320,237,252,-83,-68,0.403628092265658,0.4817346724894165,0.11463723524492542,0.3517376179395919,0.5442214937898054,0.10404088827060247,1,0,1,1,2,1,0
406,321,370,-85,-36,0.3855017026945893,0.502067061270939,0.1124312360344714,0.2819992824377666,0.6070020028028558,0.11099871475937774,1,1,1,2,4,1,0
469,361,413,-108,-56,0.4476933237181514,0.43779833442990534,0.11450834185194324,0.375663229882294,0.510654078543199,0.11368269157450724,1,0,2,1,2,1,0
313,174,253,-139,-60,0.5069801802768056,0.3778397193737855,0.11518010034940895,0.5210629961303945,0.35685894856441497,0.12207805530519043,0,0,1,1,0,1,0
309,213,346,-96,37,0.4121742721313498,0.4747590453712386,0.11306668249741171,0.23979454087441687,0.6234179522464265,0.1367875068791565,1,0,1,1,2,0,0
349,320,333,-29,-16,0.46026599502128873,0.42308354511497503,0.1166504598637361,0.4636335983078641,0.41939365915899973,0.11697274253313622,0,0,3,1,0,1,0
298,286,324,-12,26,0.4538524060753038,0.43040144891618964,0.11574614500850647,0.34233939139657926,0.5497125660282434,0.10794804257517729,1,0,1,2,2,0,0
251,237,332,-14,81,0.5276322635744998,0.35464156774220773,0.1177261686832927,0.43071624457358715,0.4565552431153875,0.11272851231102564,1,0,1,2,2,0,0
358,268,328,-90,-30,0.45650211380069783,0.428244908499829,0.11525297769947314,0.24490367466749685,0.6194652556420398,0.13563106969046348,1,0,1,1,2,1,0
465,391,421,-74,-44,0.427587963325999,0.4603089530169282,0.1121030836570727,0.4892283251499554,0.40289907427456023,0.10787260057548448,0,1,2,4,1,1,0
362,181,375,-181,13,0.32297649301061393,0.5670989604028119,0.10992454658657433,0.38038388883507607,0.5096397102377197,0.10997640092720427,1,0,1,1,2,0,0
94,0,46,-94,-48,0.49238209799724697,0.3939048454158174,0.11371305658693537,0.4407189159488718,0.4538987506237528,0.10538233342737531,0,0,1,1,0,1,0
297,256,275,-41,-22,0.35087497168828247,0.5394323569593179,0.10969267135239973,0.40588856806831924,0.4616637967134607,0.13244763521822028,0,0,2,2,0,1,0
277,24,124,-253,-153,0.48686602674172813,0.39769888191813396,0.11543509134013788,0.47919946672165464,0.4081808268524896,0.11261970642585596,0,1,2,1,1,1,0
310,277,296,-33,-14,0.398505364847457,0.49260326905980967,0.1088913660927335,0.4548979095913753,0.42053679876556177,0.12456529164306288,1,0,1,1,2,1,0
316,253,274,-63,-42,0.4717550232519801,0.40994617479264434,0.11829880195537557,0.4022185493420889,0.47609201047815597,0.12168944017975496,0,0,2,2,0,1,0
299,209,274,-90,-25,0.5125600841263936,0.371098737523699,0.11634117834990748,0.5367981430044775,0.34189092598691306,0.1213109310086093,1,1,1,1,4,1,0
354,168,202,-186,-152,0.45048413592317876,0.43645298723178116,0.11306287684504034,0.44544666311674463,0.43067968871375756,0.12387364816949784,0,0,3,1,0,1,0
319,144,188,-175,-131,0.4747806038868883,0.4139510659553568,0.11126833015775514,0.40091682309555565,0.4861207628226274,0.11296241408181702,1,1,1,3,4,1,0
327,257,299,-70,-28,0.4928157978323248,0.3870688800629911,0.1201153221046841,0.39633111753701644,0.48670590886404275,0.11696297359894074,0,0,2,1,0,1,0
82,0,70,-82,-12,0.4888305663948545,0.39610356654114987,0.1150658670639957,0.5178672596837772,0.36672305696185403,0.11540968335436882,0,0,1,1,0,1,0
496,351,444,-145,-52,0.4520051277801456,0.43073468272163096,0.1172601894982236,0.3567975593850391,0.518151531452441,0.12505090916251993,1,0,1,1,2,1,0
338,204,319,-134,-19,0.44642046629414645,0.4371257395356648,0.11645379417018886,0.44379597686189676,0.4580782589494578,0.09812576418864541,1,0,1,1,3,1,0
324,255,336,-69,12,0.39169480346533486,0.49391960700919935,0.11438558952546558,0.1958916777138231,0.6929880565372444,0.11112026574893234,0,1,2,3,1,0,0
246,184,196,-62,-50,0.44373332761242856,0.4427310905309132,0.11353558185665827,0.4345768265944801,0.44003472226831153,0.1253884511372084,0,0,1,1,0,1,0
315,268,339,-47,24,0.39363242487116895,0.4887235526095139,0.1176440225193172,0.4368341464823159,0.40966760211647757,0.15349825140120646,1,1,1,1,4,0,0
308,143,209,-165,-99,0.4447960869387069,0.44200887108444425,0.11319504197684871,0.5046185379764574,0.38497618019578195,0.1104052818277609,1,1,1,2,4,1,0
499,270,424,-229,-75,0.5838351313662049,0.28559038931482006,0.13057447931897517,0.4707968367736982,0.3911976545774224,0.13800550864887923,0,0,2,1,0,1,0
449,325,434,-124,-15,0.5236366679365264,0.3559339005370875,0.12042943152638613,0.3005147163779371,0.5790547935848716,0.12043049003719114,0,0,3,1,0,1,0
287,320,350,33,63,0.47339770609996246,0.41117443098634254,0.11542786291369482,0.40452935636979215,0.46581644386717797,0.12965419976302972,0,1,2,2,1,0,1
266,117,188,-149,-78,0.4330982837119493,0.4529430433197638,0.11395867296828673,0.38440071260188347,0.5002692926189699,0.11532999477914661,1,0,2,2,3,1,0
329,135,297,-194,-32,0.4637335449389227,0.4194621794148614,0.11680427564621594,0.4448609028678676,0.447816392158014,0.10732270497411824,1,0,1,1,2,1,0
114,68,97,-46,-17,0.387557060328437,0.5012545223978613,0.1111884172737015,0.42996157871153934,0.4646297126142723,0.10540870867418861,0,1,2,2,1,1,0
336,302,322,-34,-14,0.3960844152400231,0.4906251309284385,0.1132904538315384,0.28231185033792516,0.6268604719402104,0.09082767772186444,1,1,1,3,4,1,0
370,303,347,-67,-23,0.421166726255585,0.4627050402683084,0.1161282334761067,0.3446731489873971,0.5484640026098722,0.10686284840273072,1,1,1,4,4,1,0
371,294,344,-77,-27,0.4941283680060209,0.38727150973434166,0.11860012225963713,0.44931267177443174,0.4400046159900235,0.11068271223554463,0,1,1,1,1,1,0
178,0,64,-178,-114,0.45991161444941736,0.4263284664823126,0.11375991906826974,0.5255606959025263,0.3602357458082775,0.1142035582891961,1,0,1,2,3,1,0
255,167,194,-88,-61,0.5044250873277474,0.3834626768813603,0.11211223579089234,0.39929427724913485,0.46043060481949655,0.14027511793136896,0,1,2,1,1,1,0
209,157,170,-52,-39,0.4680388681930119,0.42197252119331374,0.10998861061367456,0.483455271728393,0.4064544823142909,0.11009024595731617,1,1,1,1,4,1,0
365,119,195,-246,-170,0.4447960869387069,0.44200887108444425,0.11319504197684871,0.5046185379764574,0.38497618019578195,0.1104052818277609,1,0,1,1,2,1,0
380,329,350,-51,-30,0.3750714736832919,0.5147859846856908,0.11014254163101705,0.4034248957182053,0.48141771623828905,0.11515738804350595,1,1,3,2,4,1,0
188,161,216,-27,28,0.47101396950711294,0.41730972218459145,0.11167630830829563,0.480292116392639,0.3941357726044356,0.1255721110029254,1,1,2,2,4,0,0
298,196,227,-102,-71,0.43488998078327373,0.4509537318634922,0.11415628735323402,0.37206339627679236,0.5073990879587521,0.12053751576445577,1,1,1,1,4,1,0
390,404,492,14,102,0.4856081401501918,0.3992158040694669,0.11517605578034122,0.36683756484784197,0.492068418383873,0.1410940167682851,1,0,1,1,2,0,1
294,187,244,-107,-50,0.5208707415350835,0.3663588622977552,0.11277039616716132,0.43126526676559856,0.4697617940908546,0.09897293914354698,0,1,1,1,1,1,0
266,182,229,-84,-37,0.4536417677436433,0.4352109985792537,0.11114723367710307,0.41285214912754176,0.45806669610414297,0.12908115476831541,1,1,2,1,4,1,0
342,384,513,42,171,0.4996102765070194,0.3888886697154244,0.11150105377755622,0.6030919657546943,0.2942387760634104,0.10266925818189526,1,0,3,1,2,0,1
552,474,530,-78,-22,0.45482857549353056,0.4290233813503677,0.11614804315610172,0.24814580766763653,0.623627016319315,0.1282271760130484,0,0,1,1,0,1,0
329,257,310,-72,-19,0.47901383274497067,0.40692788255545453,0.1140582846995746,0.45289451257096675,0.45113064824122207,0.09597483918781106,1,0,2,1,2,1,0
476,597,639,121,163,0.34878767601016497,0.5417753696004526,0.10943695438938215,0.39220124193563916,0.49965532217245734,0.10814343589190356,0,0,1,1,0,0,1
310,382,424,72,114,0.41407930134207416,0.4674933885518226,0.11842731010610337,0.3767506927101279,0.49657515846823075,0.12667414882164157,1,0,1,3,2,0,1
894,813,866,-81,-28,0.36633528655074193,0.5164629006290875,0.1172018128201705,0.2297256332400352,0.627687309962583,0.14258705679738154,0,0,2,4,0,1,0
432,344,386,-88,-46,0.33609719402968347,0.5538439922237254,0.11005881374659121,0.22431500646382668,0.6447879283673518,0.13089706516882155,0,0,1,2,0,1,0
301,212,274,-89,-27,0.4545086792303166,0.4324131138093229,0.11307820696036049,0.5397545544085393,0.3652060133553217,0.09503943223613884,1,1,1,3,4,1,0
410,257,297,-153,-113,0.47085980362730356,0.4141374337619001,0.1150027626107964,0.2718973254134938,0.6154688449063538,0.1126338296801521,0,0,2,1,0,1,0
195,116,184,-79,-11,0.4447960869387069,0.44200887108444425,0.11319504197684871,0.5046185379764574,0.38497618019578195,0.1104052818277609,1,1,1,1,4,1,0
313,337,505,24,192,0.4447960869387069,0.44200887108444425,0.11319504197684871,0.5046185379764574,0.38497618019578195,0.1104052818277609,1,0,1,1,2,0,1
260,205,218,-55,-42,0.4649315454545246,0.42003108707173803,0.11503736747373727,0.429012368221387,0.4510577270062128,0.11992990477240026,1,1,3,2,4,1,0
336,267,298,-69,-38,0.4917717640387985,0.39630568631594293,0.11192254964525876,0.4842536689695934,0.4101941208051332,0.10555221022527345,1,0,1,2,3,1,0
329,187,295,-142,-34,0.42729643053460403,0.4627826546837033,0.10992091478169307,0.43355238505095445,0.44342925910642517,0.12301835584262046,0,0,1,1,0,1,0
294,361,381,67,87,0.5326927603334454,0.35596059944315855,0.11134664022339599,0.4976171835099226,0.4017334565983952,0.10064935989168218,1,0,1,1,2,0,1
361,291,340,-70,-21,0.4555476990761941,0.4301689789680968,0.11428332195570887,0.4018631463922168,0.48556116317362186,0.11257569043416114,0,1,1,3,1,1,0
96,17,79,-79,-17,0.47772667883304787,0.409996272307831,0.11227704885912136,0.49870983077319375,0.38541846379243505,0.11587170543437118,0,1,2,1,1,1,0
325,302,337,-23,12,0.5340663951982497,0.3475753280499271,0.1183582767518231,0.42750630158997155,0.42750211107377445,0.14499158733625347,1,1,1,3,4,0,0
266,188,225,-78,-41,0.4882393111997278,0.3977098576602509,0.1140508311400214,0.49335835255433763,0.40062880247776955,0.10601284496789296,1,0,1,2,2,1,0
289,248,280,-41,-9,0.3687327669093804,0.5128087700603499,0.11845846303026998,0.4594823382011302,0.410409137422852,0.13010852437601786,0,0,2,1,0,1,0
414,443,539,29,125,0.3975697075328925,0.4888576365793795,0.11357265588772815,0.3729468645606035,0.4903467069479867,0.13670642849140932,1,0,2,1,2,0,1
321,235,341,-86,20,0.44964479860063766,0.4381207375924919,0.11223446380687029,0.345976611097313,0.533600028549899,0.12042336035278832,0,0,1,2,0,0,0
326,262,297,-64,-29,0.3902737827491204,0.49763906444459605,0.1120871528062836,0.416695487157461,0.4727375633437275,0.11056694949881146,1,0,1,5,2,1,0
312,329,362,17,50,0.42217377973802517,0.46484800532632564,0.112978214935649,0.29542844745018704,0.580674478535431,0.12389707401438163,1,0,1,2,2,0,1
506,372,415,-134,-91,0.41176901688297235,0.4714471842937737,0.116783798823254,0.31109079292900704,0.5479086056397894,0.14100060143120344,1,0,3,1,2,1,0
314,379,400,65,86,0.3995462663620382,0.48617384919131673,0.11427988444664497,0.4160945558249462,0.4675636693026652,0.11634177487238852,1,0,1,2,2,0,1
377,286,319,-91,-58,0.3919344201271722,0.49462723023727184,0.11343834963555581,0.3815581621539365,0.5019155236085273,0.11652631423753601,0,0,2,2,0,1,0
282,213,325,-69,43,0.5208913742157031,0.36308097539452056,0.11602765038977642,0.3826746730524883,0.48434221527063476,0.13298311167687682,1,0,1,1,2,0,0
294,210,269,-84,-25,0.42661658031258576,0.45694751310987275,0.11643590657754128,0.4110926519817491,0.4838612827856352,0.10504606523261556,1,0,1,1,3,1,0
289,256,274,-33,-15,0.4236315850069147,0.4650508636750592,0.11131755131802601,0.5235498549288564,0.3839785426115094,0.09247160245963426,1,1,1,1,4,1,0
291,171,252,-120,-39,0.4107308272569868,0.47626003404473577,0.11300913869827768,0.44551217530975734,0.4521140024171526,0.1023738222730902,0,1,2,1,1,1,0
308,232,272,-76,-36,0.45397869146628206,0.4331147852014791,0.11290652333223877,0.45761982633466736,0.42469777476909343,0.11768239889623906,1,0,1,1,2,1,0
270,187,237,-83,-33,0.4352019802980573,0.4474328086450236,0.11736521105691884,0.4160977609107452,0.46699072531039176,0.11691151377886301,1,0,2,1,2,1,0
174,63,102,-111,-72,0.4465392034810231,0.44005671183595485,0.11340408468302234,0.4529399605402142,0.43047660401086113,0.11658343544892491,0,1,2,1,1,1,0
293,200,267,-93,-26,0.44504335093953706,0.440807657343075,0.11414899171738792,0.4823813011589136,0.4100226809557654,0.10759601788532107,1,1,2,1,4,1,0
266,0,229,-266,-37,0.5042506114795862,0.3845199461530531,0.11122944236736079,0.3936997420344844,0.49756733309397744,0.1087329248715378,0,0,1,1,0,1,0
295,119,155,-176,-140,0.45240412460525364,0.43378543832668803,0.11381043706805821,0.4548909592982388,0.43016496266015236,0.11494407804160904,1,1,2,2,4,1,0
275,127,307,-148,32,0.4312652026599055,0.4529040519850293,0.11583074535506559,0.413399622601418,0.46028652750270815,0.12631384989587377,1,0,2,1,2,0,0
347,251,315,-96,-32,0.4488734585857125,0.43844117618329964,0.11268536523098814,0.42475994127562167,0.4268153975073061,0.14842466121707207,1,0,1,3,2,1,0
288,144,259,-144,-29,0.45256657342273326,0.42967871258105456,0.11775471399621204,0.43909765172471116,0.43838506609011685,0.12251728218517188,0,1,1,2,1,1,0
303,243,292,-60,-11,0.4802088395624668,0.4029365928429362,0.11685456759459681,0.47481593038258035,0.40483972108301575,0.12034434853440397,0,1,1,2,1,1,0
282,86,124,-196,-158,0.43636755061149296,0.44835203990042866,0.11528040948807844,0.31333932952903326,0.5519697938901614,0.13469087658080534,1,0,1,1,2,1,0
353,192,319,-161,-34,0.4100916431752779,0.47758390888619373,0.11232444793852846,0.44587225739779185,0.417333643042837,0.13679409955937125,1,0,1,1,2,1,0
300,210,237,-90,-63,0.4580160992939231,0.4289345708241472,0.1130493298819299,0.4294619254971952,0.4392233302278792,0.13131474427492545,0,1,1,1,1,1,0
138,37,93,-101,-45,0.4447960869387069,0.44200887108444425,0.11319504197684871,0.5046185379764574,0.38497618019578195,0.1104052818277609,1,1,1,1,4,1,0
317,294,301,-23,-16,0.43620137142889615,0.4496838857076234,0.11411474286348032,0.48016569475399,0.40318630265431915,0.11664800259169097,1,0,4,3,2,1,0
252,299,386,47,134,0.3749485391330056,0.5126680947584594,0.11238336610853512,0.31462657912436637,0.5597128436316758,0.12566057724395802,1,0,1,1,2,0,1
285,136,184,-149,-101,0.47373235069717085,0.4090914390940837,0.11717621020874554,0.4222772768294863,0.44777947971435694,0.12994324345615643,1,1,1,1,4,1,0
290,185,271,-105,-19,0.4682371695368561,0.41888543927280814,0.11287739119033582,0.4742472550695347,0.41492295094956855,0.11082979398089686,0,0,2,1,0,1,0
332,386,461,54,129,0.514831374079483,0.36816493392126176,0.11700369199925495,0.5130677039199892,0.38045078254886217,0.1064815135311486,1,1,3,5,4,0,1
338,352,425,14,87,0.4536956697083821,0.43452156615966,0.11178276413195792,0.46895800747596444,0.4155038874899591,0.11553810503407647,1,0,4,2,2,0,1
320,205,298,-115,-22,0.4851220690907465,0.3966230398950457,0.11825489101420804,0.4452465428471215,0.4236777044205991,0.13107575273227942,0,0,2,1,0,1,0
420,336,365,-84,-55,0.4212800674514127,0.46271868402505406,0.11600124852353304,0.3023857177203836,0.5702671146295984,0.12734716765001772,1,0,1,3,2,1,0
381,350,358,-31,-23,0.48676478633487685,0.3972639912239607,0.11597122244116222,0.4304439594473912,0.4709183451209467,0.09863769543166206,0,1,2,3,1,1,0
283,219,309,-64,26,0.48808911280481226,0.3962668142309205,0.1156440729642676,0.3450013468533932,0.5304377052229425,0.1245609479236645,1,1,3,1,4,0,0
318,288,442,-30,124,0.4858484353529661,0.3960494977969216,0.11810206685011201,0.49043295598904774,0.3738081923646321,0.13575885164632015,1,0,1,1,2,0,0
636,522,537,-114,-99,0.3265964999125559,0.5645505880972886,0.10885291199015516,0.28995893653628585,0.5994903413001096,0.11055072216360484,1,0,1,2,2,1,0
399,361,377,-38,-22,0.3809137978229944,0.5046471664208658,0.11443903575613965,0.336715155123016,0.5422202798087915,0.12106456506819234,1,0,1,1,2,1,0
424,352,379,-72,-45,0.4598703094518511,0.42279099463633874,0.11733869591181015,0.4261320712989371,0.45128449184475383,0.12258343685630889,1,0,1,1,3,1,0
343,222,242,-121,-101,0.42324531453949055,0.4623676254304365,0.11438706003007272,0.4273583128484374,0.45581376819698294,0.11682791895457983,0,0,2,1,0,1,0
388,294,319,-94,-69,0.45293044366018625,0.4341695701081526,0.11289998623166103,0.3729791476009484,0.49417930076747824,0.13284155163157305,1,0,1,4,3,1,0
375,274,333,-101,-42,0.4880567411166331,0.40186797478426023,0.1100752840991065,0.34844909014935194,0.538881790967817,0.11266911888283122,0,1,1,1,1,1,0
373,238,263,-135,-110,0.49068839881224635,0.3902195901077424,0.1190920110800115,0.4082060121821705,0.46402944855298817,0.12776453926484133,0,1,1,1,1,1,0
407,331,386,-76,-21,0.43378720298965956,0.4534167373574012,0.11279605965293926,0.39571590185853533,0.4971909376600121,0.10709316048145269,0,0,1,1,0,1,0
301,273,288,-28,-13,0.3827323845561776,0.5059138313780637,0.1113537840657587,0.4197539121827897,0.4459133466098972,0.134332741207313,1,0,4,2,3,1,0
79,0,61,-79,-18,0.4320748159826721,0.4549617397146367,0.11296344430269109,0.44707830394208214,0.44178735534742564,0.11113434071049187,0,0,1,1,0,1,0
440,345,364,-95,-76,0.428029182171559,0.4511183550082661,0.12085246282017477,0.3251742435254644,0.5327606206751384,0.14206513579939714,0,0,1,3,0,1,0
311,39,63,-272,-248,0.4878452099703135,0.3979383536579306,0.11421643637175553,0.4553101237038462,0.4107641701823593,0.13392570611379448,1,0,1,1,2,1,0
242,249,281,7,39,0.46930082998516476,0.41445019594601584,0.11624897406881962,0.4768714769649265,0.4037041410417697,0.1194243819933037,1,0,1,1,3,0,1
334,255,295,-79,-39,0.43569354282608275,0.44934988698185413,0.11495657019206348,0.4202731297661151,0.47239486689603327,0.1073320033378516,1,0,2,2,2,1,0
456,338,384,-118,-72,0.44695212320696076,0.43893080021983905,0.11411707657320011,0.22583757982139502,0.6623138173684485,0.1118486028101567,1,1,4,1,4,1,0
553,348,454,-205,-99,0.42000944466303,0.462542914155106,0.11744764118186388,0.41550723499620357,0.4551377342274837,0.1293550307763128,0,0,1,3,0,1,0
233,268,423,35,190,0.40092715177434296,0.48576217446223563,0.11331067376342142,0.4054410398796315,0.4679450020763355,0.12661395804403336,1,0,1,2,2,0,1
327,280,294,-47,-33,0.46550181443965,0.4191040670139793,0.11539411854637073,0.4603863578043814,0.42223321098891853,0.11738043120670012,1,0,3,1,3,1,0
189,131,175,-58,-14,0.42849223578484,0.45788230880125963,0.1136254554139004,0.4176680886654997,0.4807150014114809,0.10161690992301933,0,1,2,2,1,1,0
294,316,335,22,41,0.4360145601204199,0.452757797701681,0.11122764217789897,0.469162578809813,0.4054345702488233,0.12540285094136355,1,0,2,1,2,0,1
237,58,169,-179,-68,0.4447960869387069,0.44200887108444425,0.11319504197684871,0.5046185379764574,0.38497618019578195,0.1104052818277609,1,0,1,1,2,1,0
355,273,329,-82,-26,0.4296484249534172,0.4581527209069668,0.1121988541396162,0.3957570702775619,0.48947527466380353,0.11476765505863483,1,1,2,1,4,1,0
369,319,398,-50,29,0.349137117705913,0.5379305937366666,0.11293228855742034,0.35621600831201494,0.5336623625383302,0.11012162914965513,1,0,1,4,2,0,0
280,223,242,-57,-38,0.4381558060272317,0.44812757208913306,0.11371662188363511,0.4857221533023175,0.4128350331382841,0.10144281355939841,0,0,1,2,0,1,0
419,216,309,-203,-110,0.4865785104203885,0.3984871635834563,0.11493432599615548,0.44201741699042585,0.45112995697489117,0.10685262603468292,1,0,3,1,2,1,0
306,331,380,25,74,0.4501833773144376,0.4352435801276824,0.11457304255788019,0.3670124816947586,0.5013557189303539,0.13163179937488745,1,0,1,1,2,0,1
143,85,160,-58,17,0.43325344966938467,0.4546406650069299,0.11210588532368541,0.5023047544006211,0.3699494618941327,0.12774578370524634,1,0,1,2,2,0,0
278,217,312,-61,34,0.41839467937100727,0.4651393581854919,0.11646596244350081,0.4130280741513485,0.43595166166844207,0.1510202641802096,0,0,1,2,0,0,0
159,130,147,-29,-12,0.4232821537416808,0.46347860592947654,0.11323924032884257,0.424565438650341,0.4680068401339088,0.10742772121575035,1,1,3,3,4,1,0
351,289,315,-62,-36,0.42543124092822876,0.46160310753995615,0.1129656515318151,0.27805695186958485,0.5923014906281564,0.12964155750225886,0,1,1,1,1,1,0
394,351,419,-43,25,0.4186044578389593,0.46722404837611997,0.11417149378492054,0.30878791578910036,0.5554253430412268,0.1357867411696725,1,0,1,3,2,0,0
240,271,337,31,97,0.45679616197314404,0.4295273165105026,0.11367652151635359,0.39476817166425066,0.4879925107422823,0.11723931759346705,0,0,1,3,0,0,1
312,229,282,-83,-30,0.4389918029854859,0.44553074700413575,0.1154774500103785,0.4940564193711768,0.38404282056821765,0.12190076006060563,0,1,1,1,1,1,0
410,288,305,-122,-105,0.4484623359949401,0.43323298143555006,0.11830468256951002,0.3886003118777235,0.49400932227943295,0.1173903658428433,0,0,2,1,0,1,0
339,358,370,19,31,0.4375836627723496,0.449950788212032,0.11246554901561842,0.39603604733533443,0.4809686602394474,0.1229952924252181,1,0,1,2,2,0,1
332,277,319,-55,-13,0.4243489950586203,0.4595627348059601,0.11608827013541957,0.4096062270047431,0.4829629397801997,0.10743083321505711,0,0,1,1,0,1,0
269,167,197,-102,-72,0.48681182146926344,0.3950114755842918,0.11817670294644485,0.4089748708901528,0.47056807470540185,0.12045705440444554,0,1,1,1,1,1,0
300,254,274,-46,-26,0.4480125548062674,0.44174953824227725,0.11023790695145504,0.43739213805313654,0.44220809729972804,0.12039976464713542,1,0,1,5,2,1,0
273,211,256,-62,-17,0.4471621323155857,0.44144142590929547,0.11139644177511901,0.47007579671661176,0.4300145845674835,0.09990961871590477,1,1,1,2,4,1,0
362,221,267,-141,-95,0.4447960869387069,0.44200887108444425,0.11319504197684871,0.5046185379764574,0.38497618019578195,0.1104052818277609,1,1,1,1,4,1,0
301,233,275,-68,-26,0.42800266251134017,0.4577624735548803,0.11423486393377956,0.4868779483813776,0.3995901645808754,0.11353188703774714,1,0,1,2,2,1,0
394,65,149,-329,-245,0.4030675581234658,0.486687232896375,0.11024520898015931,0.2688379330426636,0.5605072563955984,0.17065481056173798,1,1,1,2,4,1,0
278,249,266,-29,-12,0.45286709345726656,0.43538729792016007,0.11174560862257328,0.3976540596009161,0.49419789588667656,0.10814804451240746,1,1,1,2,4,1,0
424,353,445,-71,21,0.4738784244072751,0.4107111733440996,0.1154104022486254,0.23847458482717582,0.6475140243092576,0.11401139086356635,1,0,1,1,2,0,0
390,305,371,-85,-19,0.5066230989018984,0.37207247721905184,0.12130442387904977,0.469156977486408,0.4040132826817086,0.12682973983188325,1,0,2,1,2,1,0
304,212,270,-92,-34,0.5256250233638977,0.35586837778074887,0.11850659885535325,0.3411089432726183,0.5473573680087714,0.1115336887186103,1,1,1,2,4,1,0
294,187,220,-107,-74,0.4303284513783512,0.458183516759539,0.1114880318621098,0.443333791767235,0.4509303456640179,0.10573586256874738,0,0,1,2,0,1,0
268,233,243,-35,-25,0.38972807637157864,0.49704227316412747,0.11322965046429354,0.42269258761503153,0.45818736120558395,0.11912005117938464,1,0,1,3,2,1,0
177,80,162,-97,-15,0.5002427754162319,0.38638935307018984,0.11336787151357819,0.43132265228716477,0.4364912310054019,0.1321861167074332,0,1,1,1,1,1,0
364,193,310,-171,-54,0.43576695485192435,0.4459129804668236,0.11832006468125182,0.45540162574854365,0.4106412034429601,0.1339571708084961,1,0,1,1,2,1,0
296,149,258,-147,-38,0.4400588020295058,0.4468272369699848,0.1131139610005095,0.4631853459185889,0.4113399008584019,0.1254747532230095,1,0,1,1,2,1,0
346,266,323,-80,-23,0.4866357097417112,0.3989747827686931,0.11438950748959581,0.4949322608626222,0.41609620125943886,0.08897153787793871,0,1,1,3,1,1,0
175,45,94,-130,-81,0.4583974327298881,0.4304850212758409,0.11111754599427098,0.5154298616299373,0.3799276015618112,0.10464253680825164,0,1,1,1,1,1,0
310,273,331,-37,21,0.5169249217317903,0.36280709919000587,0.12026797907820397,0.4003755346835176,0.46603350842555624,0.1335909568909261,1,0,1,1,2,0,0
502,458,481,-44,-21,0.38091339428109855,0.5020882308503182,0.11699837486858297,0.391582996141429,0.4771562639580981,0.1312607399004731,1,0,5,3,3,1,0
422,350,383,-72,-39,0.4677247266089315,0.42031819009020804,0.11195708330086042,0.5067981526504857,0.38609685048150977,0.1071049968680047,0,0,1,1,0,1,0
207,175,192,-32,-15,0.45174904507429264,0.43447921482841545,0.11377174009729187,0.4011795056887933,0.48963637583059,0.10918411848061692,1,1,2,2,4,1,0
290,257,274,-33,-16,0.46828368356861777,0.4197468439321767,0.11196947249920551,0.43802346036155954,0.4483491195619211,0.11362742007651917,1,1,1,1,4,1,0
442,424,473,-18,31,0.4645209097956628,0.41966019915633207,0.1158188910480053,0.3468736639781518,0.538453225842346,0.1146731101795025,1,0,1,3,2,0,0
268,15,81,-253,-187,0.4350324169672045,0.45045860030741597,0.1145089827253795,0.5192390038169639,0.3748052014766315,0.1059557947064046,1,0,2,1,2,1,0
383,293,361,-90,-22,0.42212562595621855,0.46618479590175305,0.1116895781420285,0.3483566102542462,0.5326311792091903,0.11901221053656365,1,0,1,1,2,1,0
428,299,450,-129,22,0.5000481539608957,0.3848585767739114,0.11509326926519259,0.45226616778509005,0.44668810742558784,0.10104572478932174,1,0,1,1,2,0,0
316,277,303,-39,-13,0.5048246520000018,0.37910501747120584,0.11607033052879241,0.43089559723366794,0.4622791593288136,0.10682524343751845,1,1,3,3,4,1,0
403,455,658,52,255,0.41446833961558627,0.46806638618563196,0.11746527419878167,0.384931225072938,0.5033446376932931,0.1117241372337689,1,0,2,1,2,0,1
346,247,301,-99,-45,0.41415368915216605,0.4758574268454302,0.10998888400240367,0.36700455824505446,0.4965594183405844,0.13643602341436142,0,1,1,1,1,1,0
311,266,281,-45,-30,0.44563086675577973,0.439240488450223,0.11512864479399726,0.4026399409489916,0.4691980325459777,0.12816202650503059,0,1,2,2,1,1,0
434,362,416,-72,-18,0.45899767830211186,0.4299817083717137,0.11102061332617444,0.5453116959779897,0.3464981376238484,0.10819016639816213,1,0,2,3,3,1,0
254,178,219,-76,-35,0.4776051559766681,0.4092858162068214,0.11310902781651049,0.4764604293165449,0.4167890223505751,0.10675054833287999,0,0,1,1,0,1,0
401,310,344,-91,-57,0.4437511538278815,0.4434189848937581,0.11282986127836063,0.29292238258193026,0.573070946224162,0.13400667119390816,1,0,3,3,2,1,0
202,165,179,-37,-23,0.4663291743674042,0.42176686528885476,0.11190396034374075,0.5336161503657367,0.3520453988600934,0.11433845077416992,1,0,2,2,2,1,0
218,178,233,-40,15,0.39295014244447807,0.49425747790323193,0.11279237965228979,0.3881583049703571,0.4953341213638907,0.11650757366575247,1,0,1,1,2,0,0
597,379,559,-218,-38,0.3376548460255095,0.5574670480824566,0.10487810589203367,0.33879217944393136,0.5462094647033808,0.11499835585268804,1,0,2,1,2,1,0
247,181,219,-66,-28,0.3944769283512714,0.4961635961533302,0.109359475495398,0.3956097095883111,0.4923443937586806,0.11204589665300836,0,1,1,1,1,1,0
290,314,362,24,72,0.4787427225167965,0.40473639029254815,0.11652088719065508,0.27847064640036856,0.6038066299790772,0.11772272362055412,1,1,3,1,4,0,1
366,293,314,-73,-52,0.48308810270444336,0.40102311563416715,0.11588878166138927,0.437967437745149,0.44108638824257645,0.12094617401227437,0,0,1,1,0,1,0
349,295,325,-54,-24,0.48922674338011357,0.3934373315858914,0.11733592503399502,0.44595039988704505,0.44082323171084314,0.11322636840211162,1,1,2,2,4,1,0
344,329,391,-15,47,0.4495068842568729,0.43544975879591563,0.11504335694721127,0.4019389226441699,0.47794101274026146,0.12012006461556832,0,0,1,4,0,0,0
378,319,403,-59,25,0.4752579497827387,0.41217969922097797,0.1125623509962833,0.3616795404419731,0.5142890626953275,0.1240313968626992,1,0,1,3,2,0,0
242,335,355,93,113,0.3988230670225771,0.4872166924741823,0.1139602405032406,0.46630557913263393,0.415438862012004,0.11825555885536204,0,0,1,2,0,0,1
445,319,373,-126,-72,0.3686024354029447,0.5213230449119374,0.11007451968511803,0.2780631672107639,0.5882384683736315,0.1336983644156046,0,0,2,1,0,1,0
415,323,376,-92,-39,0.40279327741196796,0.484655833933095,0.11255088865493713,0.3638790605399805,0.5149759607015245,0.12114497875849457,0,0,1,1,0,1,0
394,311,343,-83,-51,0.4371924032011942,0.45140341358337405,0.11140418321543184,0.38646376838259,0.5031674089200827,0.1103688226973271,0,1,1,2,1,1,0
351,403,439,52,88,0.4566342747092717,0.43191439709204005,0.11145132819868805,0.2957759886290556,0.5816480382308694,0.12257597314007478,1,1,1,1,4,0,1
242,49,344,-193,102,0.4524193652798046,0.42896160434882324,0.11861903037137177,0.44721317065121513,0.42387598551284944,0.12891084383593546,1,0,1,1,2,0,0
310,147,385,-163,75,0.48083097117481083,0.4000021078706318,0.11916692095455747,0.30178896742306716,0.5846286447438369,0.11358238783309582,1,1,1,2,4,0,0
335,382,418,47,83,0.45777429800519953,0.4221151663308371,0.12011053566396354,0.41605098039917854,0.4630245739045332,0.12092444569628837,1,0,1,2,2,0,1
233,273,294,40,61,0.4550903843564969,0.43258726864071706,0.11232234700278608,0.3877279817343378,0.4885369137648126,0.12373510450084946,1,1,3,4,4,0,1
369,258,348,-111,-21,0.43716284535020694,0.4388702555159309,0.1239668991338618,0.41850057048597716,0.4903902585944615,0.09110917091956133,0,0,1,1,0,1,0
253,119,236,-134,-17,0.45490710593345657,0.4315858183546613,0.11350707571188216,0.4793662212504553,0.40929065768346296,0.11134312106608155,1,0,1,1,2,1,0
429,383,400,-46,-29,0.3938783601313508,0.49321290509143334,0.11290873477721573,0.27822607440669495,0.5725950449756555,0.14917888061764958,1,0,1,3,3,1,0
272,160,214,-112,-58,0.4556224432574392,0.42869644270082374,0.11568111404173684,0.4308040023164168,0.446805095257386,0.12239090242619688,0,1,1,2,1,1,0
295,255,274,-40,-21,0.4506563265573737,0.4315379628960859,0.11780571054654032,0.34192684692555425,0.5313180327262647,0.12675512034818112,1,0,2,1,2,1,0
451,418,478,-33,27,0.46044453623390086,0.4293851805079469,0.11017028325815222,0.3789068707004371,0.5165458830043148,0.10454724629524804,1,0,1,4,2,0,0
331,238,262,-93,-69,0.4580317358687537,0.4249825525741169,0.11698571155712954,0.4326884472861542,0.4582929376278371,0.10901861508600924,1,1,1,5,4,1,0
319,371,421,52,102,0.4724123521065222,0.416633381120477,0.11095426677300076,0.47025262873604995,0.4188579711037615,0.11088940016018842,1,0,1,1,2,0,1
222,23,53,-199,-169,0.4543698279497198,0.43087343550127627,0.11475673654900391,0.4905453795374726,0.3995635108909208,0.10989110957160682,1,0,1,1,2,1,0
274,31,244,-243,-30,0.4516034008220917,0.434585326819704,0.11381127235820436,0.5272065554827786,0.3650036431275346,0.10778980138968669,1,1,1,1,4,1,0
239,197,258,-42,19,0.4220432737438787,0.46692949756845575,0.11102722868766536,0.4016635740446363,0.4681263700291862,0.13021005592617715,1,1,2,2,4,0,0
252,214,227,-38,-25,0.4683078651295368,0.41805393008020564,0.11363820479025771,0.48195951821717187,0.4090543161538556,0.10898616562897255,1,0,3,3,2,1,0
299,264,290,-35,-9,0.4008996966035991,0.4894342870732608,0.10966601632314024,0.3754544159620883,0.5131914381943021,0.11135414584360935,0,0,4,5,0,1,0
319,189,237,-130,-82,0.367301498695003,0.5185079640043807,0.11419053730061608,0.42103731625779306,0.46183602856595163,0.11712665517625531,0,0,3,1,0,1,0
238,249,294,11,56,0.4463049487762686,0.4342874733630627,0.11940757786066865,0.39545454315722856,0.4643294106889009,0.14021604615387076,1,0,2,2,2,0,1
373,293,389,-80,16,0.44246849867763427,0.4405579636701965,0.11697353765216892,0.38529287667462175,0.4801781162019481,0.1345290071234303,1,0,1,1,2,0,0
301,162,250,-139,-51,0.4421773122032797,0.443048534594129,0.11477415320259098,0.42117140687405086,0.477404678804288,0.101423914321661,1,1,2,1,4,1,0
273,134,374,-139,101,0.4350789444057988,0.4535238446485518,0.11139721094564964,0.4602138673727851,0.4327492388518585,0.10703689377535629,1,0,2,1,2,0,0
266,202,217,-64,-49,0.4220373829323176,0.46524306746438954,0.11271954960329279,0.4879386244729392,0.4012884511387281,0.1107729243883327,1,0,2,2,2,1,0
342,318,364,-24,22,0.5013648487348098,0.37720512102925974,0.12143003023593045,0.4803767416109978,0.40357827182825423,0.11604498656074792,1,0,1,3,2,0,0
262,190,224,-72,-38,0.43291508591829275,0.45303607572766436,0.11404883835404303,0.44638351543192967,0.44109574149576314,0.11252074307230721,1,0,1,1,2,1,0
476,403,468,-73,-8,0.43445402389586574,0.452932969345235,0.11261300675889922,0.4514021357980409,0.42899759023398776,0.11960027396797102,1,0,2,1,2,1,0
364,286,352,-78,-12,0.4204892807976876,0.4664739324940927,0.11303678670821973,0.3804503385731687,0.4957088291261769,0.12384083230065447,1,1,2,1,4,1,0
385,251,474,-134,89,0.4701817352940121,0.4147997965771318,0.11501846812885656,0.5455281635218444,0.3513456188315121,0.10312621764664351,1,0,1,1,3,0,0
288,352,395,64,107,0.42139364102119564,0.4620335587461258,0.11657280023267878,0.39864580304418545,0.4929496311067115,0.10840456584910306,1,0,1,2,2,0,1
381,313,333,-68,-48,0.5036514718751625,0.37893474110413566,0.11741378702070175,0.4148188840254895,0.4809688373559434,0.10421227861856724,1,0,2,1,2,1,0
286,327,366,41,80,0.4403326002819771,0.4472302112344436,0.11243718848357945,0.3774792699055089,0.5079886367555623,0.11453209333892873,1,0,1,1,3,0,1
322,363,448,41,126,0.39263008672965294,0.49845810732258167,0.10891180594776519,0.4221903918245697,0.4356254413344463,0.14218416684098364,1,0,5,1,2,0,1
324,113,155,-211,-169,0.4666952970467415,0.41997533034804235,0.11332937260521607,0.38765647131308895,0.48827643810847116,0.12406709057843998,1,1,1,1,4,1,0
360,308,333,-52,-27,0.43011512877229774,0.4583996638036089,0.11148520742409329,0.5056134844580314,0.3847397342808649,0.10964678126110346,1,1,1,2,4,1,0
241,187,197,-54,-44,0.4730417357597075,0.4124273638969032,0.11453090034338921,0.48695262465171596,0.4008840297532671,0.11216334559501694,0,1,1,1,1,1,0
373,336,463,-37,90,0.3896549758615117,0.49360583095528926,0.11673919318319885,0.23795031807026223,0.628256608534351,0.13379307339538699,0,0,2,1,0,0,0
365,603,634,238,269,0.4450096164300517,0.44328528069542644,0.11170510287452141,0.4577082576760074,0.43517740696432744,0.1071143353596651,1,0,13,1,2,0,1
331,212,281,-119,-50,0.45927917858390016,0.42240996050371765,0.1183108609123823,0.45128307657058053,0.44038114966924113,0.10833577376017818,1,1,1,1,4,1,0
252,178,229,-74,-23,0.40849502876197824,0.48385042533375505,0.10765454590426647,0.4602748630932625,0.4272712591647188,0.11245387774201887,1,0,3,2,2,1,0
295,224,276,-71,-19,0.4662481126984237,0.4196781354294708,0.11407375187210533,0.548196798898154,0.34709272012641373,0.10471048097543242,1,1,1,1,4,1,0
289,123,255,-166,-34,0.4505328572994251,0.43432001305430756,0.11514712964626729,0.49552229041460016,0.38456367011992915,0.11991403946547068,1,1,1,1,4,1,0
309,240,297,-69,-12,0.419691185178282,0.46869584846905066,0.11161296635266739,0.42948349411186704,0.45837915028049725,0.11213735560763534,1,0,1,1,2,1,0
240,186,214,-54,-26,0.4757473163445663,0.41205133835023333,0.11220134530520058,0.4725518729195515,0.40586636858383884,0.12158175849660946,1,0,2,1,2,1,0
296,332,412,36,116,0.41058799673841384,0.4732280869002219,0.11618391636136415,0.30390855480688334,0.564545037520608,0.1315464076725084,1,0,1,1,2,0,1
258,176,204,-82,-54,0.42616426320527334,0.46213301768023046,0.1117027191144961,0.5415606897449465,0.3598350803226144,0.09860422993243895,0,1,1,2,1,1,0
303,255,278,-48,-25,0.4329968871892312,0.4545251302347335,0.11247798257603539,0.44300340926341625,0.4465386104061653,0.1104579803304186,1,1,2,3,4,1,0
316,242,280,-74,-36,0.4275924884830287,0.4585180267954335,0.11388948472153747,0.4609081732558157,0.3957049486525402,0.14338687809164385,1,0,3,1,2,1,0
358,274,323,-84,-35,0.39907004310612565,0.4892014681540828,0.11172848873979137,0.34776058683194006,0.5416574416696014,0.1105819714984586,0,0,1,1,0,1,0
256,195,239,-61,-17,0.4310249359020463,0.45468845216132847,0.11428661193662507,0.5053372017365706,0.390447503943229,0.10421529432020031,1,1,2,2,4,1,0
348,289,554,-59,206,0.3960647860739594,0.48781328013308767,0.11612193379295302,0.3742336377616233,0.5179656536285422,0.10780070860983453,1,0,1,1,2,0,0
435,342,427,-93,-8,0.38357100470557326,0.504146536227294,0.11228245906713265,0.352910065789007,0.4899547777706403,0.15713515644035247,1,1,3,1,4,1,0
369,318,353,-51,-16,0.4488726730658904,0.434568763206857,0.11655856372725268,0.3576209794198042,0.5281069929259413,0.11427202765425443,1,0,3,4,2,1,0
242,105,198,-137,-44,0.46310535159104477,0.422630811030543,0.1142638373784119,0.4754633656099666,0.41278325063019483,0.11175338375983838,0,0,2,1,0,1,0
287,238,269,-49,-18,0.43544681783177974,0.4458956389755182,0.11865754319270197,0.40370359537792094,0.49143172434165605,0.10486468028042312,1,1,1,1,4,1,0
292,163,257,-129,-35,0.4668792320075495,0.41793644741335384,0.1151843205790965,0.3295434940727463,0.5445414338725082,0.12591507205474528,1,0,1,2,2,1,0
368,0,303,-368,-65,0.4726912699917681,0.41313871344811637,0.11417001656011573,0.3450739682144999,0.54721944599464,0.10770658579086,1,1,1,1,4,1,0
310,217,295,-93,-15,0.49685651733101266,0.38791774169319243,0.11522574097579502,0.43575492370918895,0.4321966501279329,0.13204842616287812,0,0,1,1,0,1,0
316,42,353,-274,37,0.4447960869387069,0.44200887108444425,0.11319504197684871,0.5046185379764574,0.38497618019578195,0.1104052818277609,0,0,1,4,0,0,0
448,327,366,-121,-82,0.44037408204989936,0.44692216391827816,0.1127037540318224,0.39970054678245237,0.47322006561017826,0.12707938760736912,1,0,1,1,3,1,0
313,273,289,-40,-24,0.40382209824589044,0.4818036611370468,0.11437424061706261,0.44187598017569363,0.447677790541419,0.11044622928288725,0,0,1,2,0,1,0
275,291,297,16,22,0.4910135284869303,0.3947399023555073,0.1142465691575624,0.5188713138972629,0.3793340794713335,0.10179460663140345,1,0,4,3,2,0,1
344,293,318,-51,-26,0.4448786874444666,0.4438168147545812,0.11130449780095211,0.4112259818164027,0.4853268050348635,0.10344721314873344,1,0,3,1,2,1,0
222,123,196,-99,-26,0.5090432429626618,0.37664587556866425,0.11431088146867391,0.4094101906835448,0.471011551999221,0.11957825731723416,0,1,3,1,1,1,0
160,0,77,-160,-83,0.4460042167260584,0.43525531990634336,0.11874046336759808,0.41222116322953706,0.47875635658732096,0.10902248018314209,0,0,1,1,0,1,0
396,293,359,-103,-37,0.4718532271974679,0.41474032243068704,0.11340645037184521,0.4098723145692842,0.48480631683796044,0.10532136859275562,1,0,1,1,2,1,0
241,0,185,-241,-56,0.44696943204593365,0.4377916062554967,0.1152389616985698,0.39965707893979563,0.4823060662763902,0.11803685478381426,0,0,1,1,0,1,0
337,0,255,-337,-82,0.41934230955854723,0.4677353620005342,0.11292232844091854,0.4629304826810773,0.43177689471843295,0.10529262260048997,0,1,1,1,1,1,0
290,50,71,-240,-219,0.4148719918471794,0.47461204916299066,0.11051595898983001,0.4357216855275785,0.4426750989368848,0.12160321553553678,1,1,1,1,4,1,0
353,73,365,-280,12,0.4632854917575161,0.42577160033696765,0.1109429079055163,0.4050695725395819,0.4653869035541616,0.1295435239062563,1,0,1,1,2,0,0
319,152,199,-167,-120,0.4445702942766897,0.44325867270002844,0.11217103302328159,0.41433170774184436,0.4738800299081183,0.1117882623500372,1,0,2,1,2,1,0
361,273,297,-88,-64,0.42753628656795506,0.45901029947547245,0.11345341395657256,0.4369953564413998,0.4619020043487465,0.10110263920985381,0,0,1,1,0,1,0
301,313,330,12,29,0.4814402103083328,0.40218366759414087,0.11637612209752632,0.2249210955115774,0.6443164232178074,0.13076248127061538,1,0,1,2,2,0,1
303,199,270,-104,-33,0.38603648345054464,0.49991059554903516,0.1140529210004201,0.36469658133289207,0.5118111820186345,0.12349223664847293,1,1,1,2,4,1,0
306,204,264,-102,-42,0.46261907997310003,0.4243615442194214,0.11301937580747833,0.46947449351070125,0.41090238907999854,0.11962311740929991,1,0,1,1,3,1,0
398,178,449,-220,51,0.44633773015282635,0.43959009317314446,0.11407217667402902,0.4122145161285514,0.46059096552139117,0.12719451835005727,1,0,1,2,2,0,0
207,175,189,-32,-18,0.44487421259654586,0.4407182197506927,0.11440756765276118,0.5073111520424821,0.38924594991612316,0.10344289804139462,0,0,1,1,0,1,0
422,279,306,-143,-116,0.4593145817669488,0.4263341971717059,0.11435122106134517,0.3112942168871651,0.5765980674156164,0.11210771569721893,0,0,1,1,0,1,0
286,238,268,-48,-18,0.4114998255483335,0.4752234697427956,0.11327670470887084,0.4304688988729332,0.4572556432812899,0.11227545784577699,0,1,3,2,1,1,0
288,218,242,-70,-46,0.42464025982287784,0.4613312624487864,0.11402847772833567,0.41464342380350677,0.45657742201051976,0.12877915418597347,1,0,1,1,3,1,0
389,316,357,-73,-32,0.47509284821990705,0.4143012599099967,0.11060589187009626,0.47284782705067396,0.4244244934498988,0.10272767949942713,1,0,1,3,2,1,0
395,343,354,-52,-41,0.3846809900691685,0.5045619463361272,0.11075706359470469,0.2755285177579934,0.5940480845122916,0.13042339772971506,1,0,4,4,2,1,0
266,196,215,-70,-51,0.41850498845177614,0.4700816478176506,0.11141336373057334,0.4182468235878888,0.4619743374605748,0.11977883895153646,0,1,1,1,1,1,0
313,265,286,-48,-27,0.4351357724044525,0.45052975104122217,0.11433447655432531,0.4277045626886092,0.45155634425270225,0.12073909305868857,1,1,2,2,4,1,0
173,0,74,-173,-99,0.49661234846310515,0.38734780857909273,0.11603984295780195,0.44427142913451423,0.4417736753918437,0.113954895473642,0,1,1,1,1,1,0
621,391,539,-230,-82,0.510499280495872,0.3777396424801323,0.1117610770239957,0.4783030948548827,0.3923626323850776,0.12933427276003948,1,0,3,1,2,1,0
288,299,420,11,132,0.43012075741776973,0.45155025480059535,0.1183289877816347,0.33551788228154583,0.5541158259289585,0.11036629178949574,1,0,1,1,2,0,1
458,418,435,-40,-23,0.3741932668085525,0.5164208664799791,0.1093858667114684,0.3250695976965293,0.5638878981122499,0.11104250419122041,1,0,2,4,3,1,0
294,107,212,-187,-82,0.4885390196743115,0.4003338355954375,0.1111271447302511,0.3846619714876797,0.5032341129152326,0.11210391559708781,1,0,1,1,2,1,0
355,224,332,-131,-23,0.4843409799258696,0.40776249419016475,0.10789652588396552,0.52594810160047,0.38368830824129285,0.09036359015823703,0,0,2,1,0,1,0
302,153,254,-149,-48,0.41549660332191124,0.47259014347403944,0.11191325320404907,0.3562479000877569,0.5382187672044391,0.10553333270780403,1,1,1,2,4,1,0
342,275,307,-67,-35,0.4058023277072489,0.4826025649026164,0.11159510739013485,0.4600277294563568,0.43256403076449934,0.10740823977914371,1,0,3,2,3,1,0
266,205,219,-61,-47,0.4604132076257101,0.4256637374992112,0.1139230548750786,0.49031311619300094,0.38857225735632767,0.12111462645067139,1,1,1,1,4,1,0
273,255,292,-18,19,0.4637583766225747,0.4199820922764452,0.11625953110098042,0.5404394681096482,0.35691197303329014,0.10264855885706159,1,0,1,2,2,0,0
376,426,472,50,96,0.49512357237892457,0.3912842773726917,0.11359215024838339,0.5035978228936381,0.38824152781267557,0.10816064929368632,1,1,1,2,4,0,1
288,89,262,-199,-26,0.4527897880138303,0.43280966550549527,0.11440054648067458,0.5119895463537933,0.3718468442670148,0.11616360937919167,1,1,1,1,4,1,0
320,245,278,-75,-42,0.4714884273064935,0.41405277992611844,0.11445879276738768,0.4907574171135005,0.38324767806981264,0.1259949048166866,1,0,1,2,2,1,0
430,347,460,-83,30,0.36025651480556364,0.5241792842348226,0.11556420095961369,0.3661649065282077,0.4793418457765186,0.15449324769527364,1,0,2,1,3,0,0
351,188,311,-163,-40,0.4376350303748929,0.44373063117204403,0.11863433845306287,0.40665669053581,0.4618730745535532,0.1314702349106367,0,0,1,1,0,1,0
375,348,363,-27,-12,0.40594506926068047,0.4842770144823931,0.10977791625692652,0.3939858683054755,0.4997219954955757,0.10629213619894907,1,1,2,3,4,1,0
316,259,285,-57,-31,0.44176314506429565,0.44543684684512247,0.11280000809058197,0.5112495978595679,0.37684591855600147,0.11190448358443048,0,1,1,3,1,1,0
312,464,518,152,206,0.39846452529892884,0.48929498812371247,0.11224048657735854,0.33339157074775466,0.5406180036201408,0.12599042563210436,1,1,2,1,4,0,1
232,100,119,-132,-113,0.5076213573248186,0.3752437159755957,0.11713492669958558,0.47836373145286054,0.3990897395332156,0.12254652901392395,0,1,1,1,1,1,0
460,378,426,-82,-34,0.43667627583377816,0.44575903767787955,0.11756468648834212,0.35377276689465936,0.5072231392446409,0.13900409386069956,0,0,1,2,0,1,0
332,469,480,137,148,0.5079972687365633,0.3783351735713125,0.11366755769212435,0.4915173158285455,0.38624313173770364,0.12223955243375077,1,0,2,1,2,0,1
445,363,412,-82,-33,0.43647696169854155,0.4494330775895961,0.11408996071186271,0.3722017693183256,0.5198830274928437,0.10791520318883091,1,0,1,3,3,1,0
370,256,349,-114,-21,0.5496443585536241,0.33126070969037685,0.11909493175599918,0.30782415654589074,0.5700329437142805,0.12214289973982874,0,0,1,2,0,1,0
421,361,384,-60,-37,0.47054418679122717,0.4148278828281724,0.11462793038060057,0.38453003162528887,0.49666645989744374,0.11880350847726713,1,0,3,1,2,1,0
352,258,302,-94,-50,0.34732107407458135,0.5397789347716027,0.11289999115381609,0.40123940250761064,0.4769849789386533,0.12177561855373599,0,0,1,2,0,1,0
79,0,127,-79,48,0.4577634303621005,0.42932669952871566,0.11290987010918387,0.4468364488710332,0.44093271325818956,0.11223083787077706,1,0,1,1,2,0,0
269,197,300,-72,31,0.43694906596498445,0.44861434581709003,0.11443658821792566,0.3787605795985339,0.5037081884984419,0.11753123190302389,1,1,2,1,4,0,0
225,0,159,-225,-66,0.4724800722909459,0.417997711721269,0.10952221598778505,0.42444998144006374,0.4378790568402544,0.13767096171968202,0,1,1,1,1,1,0
296,203,215,-93,-81,0.46267446203407775,0.42533544357156394,0.11199009439435836,0.40422296735279273,0.48994648438484656,0.1058305482623607,0,0,1,1,0,1,0
192,243,264,51,72,0.43166402873793347,0.45535081141595124,0.11298515984611508,0.40449652636708844,0.47109695228521803,0.12440652134769353,1,1,1,2,4,0,1
325,185,212,-140,-113,0.43052422957818876,0.4562038077525066,0.11327196266930481,0.35994389736745214,0.5136513811247692,0.12640472150777846,1,1,1,1,4,1,0
449,312,329,-137,-120,0.4044127305420786,0.4809268871090514,0.11466038234886995,0.3885327601244063,0.4618291817180033,0.1496380581575904,0,0,1,1,0,1,0
321,269,298,-52,-23,0.4739866668745069,0.4120665437134377,0.11394678941205547,0.5845417744446622,0.3232792527087749,0.09217897284656294,0,1,3,1,1,1,0
260,196,228,-64,-32,0.43487256057711415,0.44941313711533887,0.11571430230754723,0.5375237524257435,0.3537918276248587,0.10868441994939748,1,0,1,2,3,1,0
348,265,333,-83,-15,0.38420475638876705,0.5047516156294368,0.11104362798179611,0.3320913343438188,0.5615284068502036,0.10638025880597783,1,0,2,3,3,1,0
238,200,211,-38,-27,0.45001818875111055,0.435140022617978,0.11484178863091107,0.48621755576682946,0.4032993893447135,0.11048305488845685,1,0,1,2,3,1,0
382,266,434,-116,52,0.39028480142887895,0.49556156888573544,0.11415362968538573,0.38511217398289865,0.5001530573494041,0.11473476866769708,1,0,1,1,2,0,0
211,21,67,-190,-144,0.45644410492028653,0.430918921607363,0.11263697347235033,0.471615597040217,0.4093080653655408,0.11907633759424226,1,1,1,1,4,1,0
348,220,312,-128,-36,0.45976027677996273,0.42376881610991596,0.11647090711012144,0.33588140082319173,0.536147790826537,0.12797080835027133,0,0,1,1,0,1,0
444,456,473,12,29,0.4555239905987278,0.4301051434435553,0.11437086595771691,0.4470923974297173,0.4325702115703426,0.12033739099994027,1,0,1,1,2,0,1
412,249,518,-163,106,0.4867354108387279,0.3991926602246065,0.11407192893666594,0.5171022641624784,0.3557054573122446,0.127192278525277,0,0,3,1,0,0,0
383,239,367,-144,-16,0.3714687773835051,0.5181622533621364,0.11036896925435832,0.3617675340941129,0.5297153267734027,0.10851713913248472,0,0,3,1,0,1,0
391,461,653,70,262,0.4655979814059562,0.41941926646969485,0.11498275212434896,0.3576188149809923,0.5294017823260516,0.1129794026929564,1,0,1,2,2,0,1
289,193,301,-96,12,0.4266841186936258,0.4615957431645836,0.11172013814179034,0.4497343264499868,0.42781282690898037,0.12245284664103283,1,0,1,1,2,0,0
222,185,201,-37,-21,0.48839916270537104,0.3981992535594931,0.11340158373513604,0.5569622480446339,0.3418420953343353,0.10119565662103056,0,0,2,2,0,1,0
312,336,398,24,86,0.5350475471146032,0.3510444945355318,0.11390795834986496,0.44802146420135963,0.4238502921031718,0.12812824369546852,0,0,3,1,0,0,1
265,285,355,20,90,0.47737959541312824,0.409227859344061,0.11339254524281057,0.5112687430212818,0.3827612937215272,0.10596996325719076,0,0,3,2,0,0,1
421,450,549,29,128,0.44130634425168824,0.44111032926621924,0.11758332648209287,0.4321430022907919,0.4455450110108456,0.12231198669836253,1,1,3,1,4,0,1
351,272,323,-79,-28,0.45617358454954304,0.43065093785825964,0.11317547759219738,0.49168761843238723,0.4021155380316361,0.10619684353597668,1,0,1,2,3,1,0
300,328,352,28,52,0.45683719248696203,0.4300786694221189,0.11308413809091901,0.4892504305562755,0.38990055214325203,0.12084901730047239,0,0,2,1,0,0,1
392,326,378,-66,-14,0.4732955347890929,0.4077136525717373,0.11899081263916941,0.2050739868331991,0.6322708562490001,0.16265515691780044,0,0,1,1,0,1,0
270,251,282,-19,12,0.4537065197419382,0.43279703478102954,0.11349644547703241,0.42942331214904744,0.4699511150419647,0.10062557280898812,0,0,1,3,0,0,0
260,148,195,-112,-65,0.4886145830100249,0.39410357416757774,0.11728184282239718,0.4671363219671861,0.4257586831054267,0.10710499492738729,1,1,1,1,4,1,0
445,393,468,-52,23,0.37781319740122943,0.5175006370714113,0.10468616552735945,0.20458505699479482,0.6764495442084848,0.1189653987967203,1,0,1,3,2,0,0
376,281,322,-95,-54,0.4719086050753693,0.4135544244534082,0.11453697047122265,0.4109092197241297,0.47528913228639014,0.11380164798948046,1,1,1,1,4,1,0
299,327,359,28,60,0.45771674128472917,0.42859911374120874,0.11368414497406187,0.3800771230031051,0.5077567458183426,0.11216613117855216,0,1,1,2,1,0,1
566,343,479,-223,-87,0.5447257170115358,0.3419438326675058,0.11333045032095855,0.41023938918617725,0.4689688312996962,0.12079177951412638,0,0,1,1,0,1,0
335,285,294,-50,-41,0.44297784066883805,0.44405511959797206,0.1129670397331898,0.3953230932828907,0.47445314060703697,0.13022376611007225,0,1,1,2,1,1,0
284,222,271,-62,-13,0.4549504735286496,0.43046698771158143,0.11458253875976883,0.3774048038433156,0.5006888703609141,0.12190632579577022,1,0,1,1,2,1,0
367,261,300,-106,-67,0.42152951409061906,0.469886437010957,0.10858404889842412,0.3614579112226198,0.5177567562248038,0.1207853325525763,0,0,1,2,0,1,0
520,375,490,-145,-30,0.4447960869387069,0.44200887108444425,0.11319504197684871,0.5046185379764574,0.38497618019578195,0.1104052818277609,1,1,1,1,4,1,0
196,221,231,25,35,0.45197756146726065,0.4336957490383305,0.11432668949440876,0.4243596903405321,0.46945095598774067,0.10618935367172735,0,0,2,2,0,0,1
344,211,241,-133,-103,0.4270165287203892,0.4581991659026573,0.11478430537695337,0.4146232060698416,0.46844444157372706,0.11693235235643142,0,1,2,1,1,1,0
271,158,328,-113,57,0.40640624291394817,0.4798053763706916,0.11378838071536032,0.38642345697807046,0.4843794211678479,0.12919712185408183,1,1,1,1,4,0,0
359,274,314,-85,-45,0.5146694238679973,0.36493759222111044,0.12039298391089226,0.5139890175833938,0.3793725083410751,0.106638474075531,0,1,1,1,1,1,0
247,147,221,-100,-26,0.434569063179044,0.4502116022188253,0.11521933460213092,0.41721843307024203,0.4456217183975934,0.13715984853216448,0,0,1,1,0,1,0
265,150,210,-115,-55,0.459740444131491,0.4242237056845422,0.11603585018396664,0.4099821127043151,0.4535568224274476,0.1364610648682372,0,0,1,3,0,1,0
316,281,299,-35,-17,0.4252115090888207,0.46255562554095525,0.11223286537022423,0.3670565197313319,0.5169449435369236,0.11599853673174478,0,0,2,1,0,1,0
301,159,256,-142,-45,0.47231216339761806,0.41398839608435356,0.11369944051802795,0.4990018009279529,0.38852835779603817,0.11246984127600894,0,0,1,2,0,1,0
436,382,420,-54,-16,0.5746372279693066,0.31157202243829013,0.11379074959240308,0.4053816176241696,0.44743683493956565,0.14718154743626455,0,0,1,1,0,1,0
278,182,241,-96,-37,0.41722097581748296,0.471539837317611,0.11123918686490589,0.3999883575133665,0.4775492249371702,0.12246241754946326,1,0,2,2,2,1,0
251,175,238,-76,-13,0.4867651046721153,0.40359083764899273,0.10964405767889195,0.4016309524986589,0.49200331469486175,0.10636573280647948,1,0,2,1,2,1,0
343,217,267,-126,-76,0.439257093442296,0.4468205291916784,0.11392237736602547,0.3810660520004311,0.5098484214103401,0.10908552658922872,1,0,1,2,2,1,0
406,355,373,-51,-33,0.42424558531581025,0.4707692076812118,0.10498520700297784,0.3669552323533336,0.4984328538728538,0.13461191377381243,1,0,1,2,2,1,0
286,139,250,-147,-36,0.45584266104729526,0.43420822077348814,0.10994911817921664,0.49089347982697124,0.38409989100216596,0.12500662917086244,0,1,1,1,1,1,0
337,234,308,-103,-29,0.4708730284359701,0.41172875620998217,0.11739821535404803,0.3674885159307639,0.5037183974986391,0.12879308657059685,1,1,1,1,4,1,0
304,242,292,-62,-12,0.4400978220947488,0.4469424059370063,0.11295977196824501,0.42271979773861146,0.440831909565126,0.13644829269626255,0,0,2,4,0,1,0
139,92,108,-47,-31,0.4600786778311783,0.4216267626271309,0.1182945595416911,0.41313560037002,0.46462429551413137,0.12224010411584851,1,0,2,1,2,1,0
334,238,346,-96,12,0.41909538535332513,0.46721955430430073,0.11368506034237426,0.36703552744443635,0.5311260972592436,0.10183837529631994,1,1,1,1,4,0,0
509,388,429,-121,-80,0.42286418554883887,0.4556600750398467,0.1214757394113144,0.3185782862001369,0.557948330452059,0.12347338334780374,0,0,1,2,0,1,0
287,248,264,-39,-23,0.45478984159450414,0.43238427475082647,0.11282588365466947,0.42548866409756186,0.45176026243709155,0.12275107346534661,1,1,2,4,4,1,0
272,239,255,-33,-17,0.4971119218445563,0.3834628749022745,0.11942520325316879,0.38550729227393704,0.49470973611914554,0.11978297160691764,1,1,1,1,4,1,0
277,205,227,-72,-50,0.4329178596861183,0.45602782886298665,0.11105431145089521,0.4500204092527402,0.4341566862844972,0.1158229044627625,1,0,1,2,3,1,0
379,205,245,-174,-134,0.41450477357901905,0.471494951009994,0.11400027541098669,0.4187820331002084,0.4918005049463334,0.08941746195345805,1,1,1,1,4,1,0
277,176,244,-101,-33,0.4197576975180132,0.47100258920478777,0.10923971327719903,0.42388050729688753,0.45379900033953247,0.12232049236358015,0,0,1,1,0,1,0
361,217,246,-144,-115,0.40423171083398685,0.4834431903100231,0.11232509885599005,0.2837392338753941,0.5776323724667067,0.13862839365789936,0,1,2,1,1,1,0
300,169,199,-131,-101,0.45992204373785034,0.42709957204294136,0.1129783842192083,0.4282142763936146,0.45476172892701844,0.11702399467936682,1,0,1,2,2,1,0
386,396,437,10,51,0.5234106684419181,0.3558654785496593,0.12072385300842274,0.44314866928706187,0.43235214095143815,0.12449918976150007,1,0,1,2,2,0,1
130,0,113,-130,-17,0.45683010963753484,0.4316076641978931,0.11156222616457197,0.4950847552718885,0.4036491648623397,0.10126607986577198,1,1,1,1,4,1,0
459,339,423,-120,-36,0.4483289454892576,0.43619984409919094,0.11547121041155148,0.37056426705573586,0.5196461089738585,0.10978962397040568,1,1,2,1,4,1,0
329,272,300,-57,-29,0.4751609559529644,0.413047684168133,0.11179135987890265,0.31436793878343605,0.5613489676548182,0.12428309356174577,1,0,1,1,2,1,0
498,366,379,-132,-119,0.43309801891824884,0.4534182336415819,0.11348374744016913,0.2592364559354572,0.6214625869743701,0.11930095709017276,0,0,1,2,0,1,0
313,248,263,-65,-50,0.45385326227075323,0.433627085702118,0.11251965202712887,0.46323334654014287,0.4087900380546945,0.12797661540516259,1,0,2,2,3,1,0
292,143,222,-149,-70,0.4668332085092294,0.41780430822002157,0.11536248327074902,0.4472158316051364,0.44664095011778926,0.1061432182770743,1,0,1,1,2,1,0
375,280,307,-95,-68,0.4069471615976224,0.4693091201961612,0.12374371820621653,0.2904689819356019,0.5450123214961842,0.164518696568214,0,0,3,6,0,1,0
669,772,869,103,200,0.4447960869387069,0.44200887108444425,0.11319504197684871,0.5046185379764574,0.38497618019578195,0.1104052818277609,0,0,1,1,0,0,1
331,216,255,-115,-76,0.43837495327182524,0.44918706268442044,0.11243798404375428,0.45883943542606753,0.41479558809011335,0.12636497648381861,1,1,1,2,4,1,0
358,262,290,-96,-68,0.443239568565186,0.44680688386693423,0.10995354756788,0.4236537867825679,0.4480517000261676,0.12829451319126445,1,1,1,2,4,1,0
278,289,336,11,58,0.4604113694181301,0.42150847230021043,0.1180801582816593,0.4364305401740158,0.4514820094092636,0.11208745041672066,0,0,3,2,0,0,1
330,283,309,-47,-21,0.47312261328558136,0.41057797100382953,0.11629941571058937,0.4245382251472814,0.4360907611906875,0.1393710136620311,1,0,2,4,2,1,0
334,382,525,48,191,0.4263780254785349,0.4612259116414615,0.11239606288000344,0.46642852403535984,0.42539605074634185,0.10817542521829793,1,0,2,1,2,0,1
447,335,393,-112,-54,0.39022690271817495,0.49868506853088057,0.11108802875094441,0.2726863318808659,0.5866803046408651,0.14063336347826924,1,0,3,1,3,1,0
306,228,257,-78,-49,0.4399689928958644,0.4432504404425198,0.11678056666161586,0.36288656686929677,0.49662717396941364,0.14048625916128948,1,1,1,1,4,1,0
492,513,596,21,104,0.3909532801952227,0.5000980784085365,0.10894864139624061,0.2792678844136037,0.602213440312347,0.11851867527404936,1,0,2,1,2,0,1
260,173,231,-87,-29,0.4341298840106558,0.45201047413671197,0.11385964185263232,0.5209006477642335,0.3694460660628853,0.10965328617288105,0,1,1,1,1,1,0
233,166,187,-67,-46,0.42697793927226196,0.46089791619086673,0.11212414453687129,0.4542611391573449,0.43499299227768706,0.11074586856496815,1,0,2,3,2,1,0
368,335,356,-33,-12,0.44714832311819314,0.43804977381867094,0.11480190306313612,0.46230881947797375,0.42670234891461256,0.1109888316074137,1,1,1,3,4,1,0
342,269,298,-73,-44,0.4342462640642119,0.4554132845358293,0.11034045139995893,0.4170878146045094,0.4758203916164652,0.10709179377902521,1,0,2,1,2,1,0
206,175,189,-31,-17,0.41769671607560643,0.46874829425603387,0.11355498966835982,0.47047491532686225,0.4101865439400008,0.11933854073313659,0,1,2,3,1,1,0
317,278,291,-39,-26,0.4604434116532624,0.4267703836355761,0.11278620471116159,0.3836238015200042,0.47881672055204255,0.1375594779279532,1,0,2,2,3,1,0
438,313,338,-125,-100,0.5105247204724845,0.3757304777179339,0.11374480180958157,0.3826605572640286,0.48735437226271033,0.1299850704732609,0,1,2,3,1,1,0
489,305,326,-184,-163,0.46297946845297444,0.4156585127095832,0.12136201883744209,0.3452152845562674,0.5230841189885677,0.13170059645516496,1,0,1,1,3,1,0
334,195,260,-139,-74,0.5379268185913523,0.35131769645903627,0.11075548494961156,0.5123950461072684,0.3348053579633218,0.1527995959294099,0,0,2,1,0,1,0
326,0,47,-326,-279,0.47061958294552614,0.4169431466108762,0.11243727044359753,0.44235223703890236,0.46523081900213153,0.09241694395896605,0,1,1,1,1,1,0
259,282,325,23,66,0.4501158269290182,0.43796079169691554,0.11192338137406604,0.3375578089706622,0.5341448409851548,0.12829735004418294,0,1,1,1,1,0,1
255,201,216,-54,-39,0.4500512479665946,0.4373737806193404,0.11257497141406472,0.4003280697713766,0.4788409200117972,0.12083101021682606,1,1,2,1,4,1,0
143,0,120,-143,-23,0.4677266206205018,0.4177851762496476,0.11448820312985071,0.47325280033441225,0.40241568936342953,0.12433151030215794,0,1,1,1,1,1,0
327,238,313,-89,-14,0.46988563900426505,0.4163457280892438,0.11376863290649114,0.5016269850612106,0.34618880596665846,0.1521842089721308,0,0,2,1,0,1,0
235,176,210,-59,-25,0.4519955972494578,0.43410069872746154,0.11390370402308073,0.34723902565824677,0.5257819535373981,0.12697902080435491,0,0,2,1,0,1,0
493,289,442,-204,-51,0.4447960869387069,0.44200887108444425,0.11319504197684871,0.5046185379764574,0.38497618019578195,0.1104052818277609,1,0,1,1,2,1,0
354,249,325,-105,-29,0.4391067899135224,0.4473078594480709,0.1135853506384068,0.29490679996724634,0.5540316249096768,0.15106157512307677,1,1,1,2,4,1,0
397,278,381,-119,-16,0.48918980373113863,0.398213741108724,0.11259645516013715,0.4856728040198789,0.4002438213769405,0.11408337460318096,0,0,1,1,0,1,0
362,289,318,-73,-44,0.4204547510209913,0.4661921490584997,0.11335309992050895,0.3458108963361779,0.5248589287113795,0.12933017495244228,0,0,1,2,0,1,0
558,414,490,-144,-68,0.35398253895735426,0.5280284284236144,0.11798903261903146,0.2793519453295116,0.5850639423011055,0.13558411236938311,0,0,2,1,0,1,0
76,88,112,12,36,0.44946423148686215,0.4350534888873854,0.11548227962575255,0.4761928273142894,0.39178746390106667,0.13201970878464422,1,0,1,2,2,0,1
265,53,73,-212,-192,0.44976205067473213,0.4340165430727711,0.11622140625249675,0.40330271886659724,0.46675864577256293,0.12993863536083994,0,1,1,1,1,1,0
332,300,315,-32,-17,0.4976296209804647,0.38544440084491066,0.11692597817462465,0.35136020797910267,0.5026444212532739,0.14599537076762345,1,0,3,2,3,1,0
667,90,605,-577,-62,0.4854766357049615,0.4018287641329183,0.1126946001621203,0.4522930930423422,0.425141140047612,0.12256576691004564,0,0,1,1,0,1,0
440,374,419,-66,-21,0.44775624261998825,0.43705833543734973,0.1151854219426619,0.4867721389507392,0.38854202124440534,0.12468583980485565,1,0,1,4,2,1,0
292,185,245,-107,-47,0.48272811875660604,0.40456924688512913,0.112702634358265,0.5040868981893355,0.39447178248183223,0.10144131932883216,1,1,1,1,4,1,0
494,421,529,-73,35,0.43474045707510817,0.4549370739902481,0.1103224689346436,0.302306640486832,0.5835416826508372,0.11415167686233109,1,0,1,1,2,0,0
252,202,241,-50,-11,0.44309629108485243,0.4416362987145925,0.1152674102005551,0.4747399204135424,0.4072693944214714,0.11799068516498608,1,1,1,1,4,1,0
303,183,220,-120,-83,0.46907620407393313,0.41998283289954225,0.1109409630265244,0.5057590880175611,0.38158825346535546,0.11265265851708346,1,1,2,1,4,1,0
307,274,327,-33,20,0.4765089450647343,0.40898249788660784,0.11450855704865792,0.421959386855033,0.45171956504434135,0.12632104810062586,1,0,1,4,2,0,0
331,282,317,-49,-14,0.4270401580379867,0.46159841883498376,0.11136142312702949,0.3906228664459467,0.4849754768816798,0.12440165667237338,0,0,2,1,0,1,0
241,160,252,-81,11,0.4373804159634779,0.45027812174136456,0.11234146229515762,0.40232413330950634,0.47309908531378025,0.12457678137671292,1,1,1,1,4,0,0
160,46,96,-114,-64,0.4447960869387069,0.44200887108444425,0.11319504197684871,0.5046185379764574,0.38497618019578195,0.1104052818277609,1,0,1,1,2,1,0
324,264,339,-60,15,0.47452247824094956,0.4047985070642846,0.12067901469476575,0.3852945728292077,0.46836239227932686,0.14634303489146525,1,1,2,2,4,0,0
73,0,27,-73,-46,0.455511066353042,0.4310583529973902,0.11343058064956778,0.5209439881690207,0.36545707964352875,0.11359893218745057,0,1,2,1,1,1,0
369,276,335,-93,-34,0.43558335672731807,0.4496929149492772,0.11472372832340484,0.31419484240481865,0.5583610152973114,0.12744414229787004,0,0,2,2,0,1,0
374,309,395,-65,21,0.40420845071225026,0.4792385864732007,0.11655296281454916,0.31487055566975963,0.5836791072788126,0.10145033705142818,0,1,4,4,1,0,0
330,204,240,-126,-90,0.47067170694450905,0.41719239060608776,0.11213590244940319,0.401052911236818,0.4730775228798926,0.12586956588328954,0,0,1,1,0,1,0
286,240,271,-46,-15,0.4894636640019885,0.39464845841604784,0.1158878775819637,0.38577205256832775,0.4919180907264915,0.12230985670518085,0,1,1,1,1,1,0
251,203,226,-48,-25,0.4218925351086987,0.46537687767959135,0.11273058721171009,0.49392163788452986,0.38908199933745613,0.11699636277801388,1,1,1,1,4,1,0
288,160,258,-128,-30,0.4499151899600822,0.430269540619862,0.11981526942005608,0.4058985806609464,0.46290057137562063,0.1312008479634329,1,0,2,1,2,1,0
377,294,352,-83,-25,0.4725102804852366,0.4136283126017907,0.11386140691297304,0.2640068985364782,0.5973149429032187,0.13867815856030305,0,1,3,1,1,1,0
296,212,260,-84,-36,0.4809463249471162,0.40197267619490473,0.11708099885797886,0.43832060737720374,0.43737598145316764,0.12430341116962852,0,0,1,2,0,1,0
347,202,332,-145,-15,0.46231956002108593,0.42586815784615034,0.11181228213276388,0.5012435260236711,0.39906135841880447,0.09969511555752436,0,0,1,1,0,1,0
274,194,240,-80,-34,0.451292949606443,0.4351788913477731,0.11352815904578377,0.47027764357106483,0.4226793575946713,0.1070429988342638,1,0,1,2,2,1,0
365,249,272,-116,-93,0.4380060541735707,0.4513239596815296,0.11066998614489967,0.497925493930769,0.3814442964986539,0.12063020957057702,0,1,1,2,1,1,0
324,221,271,-103,-53,0.4896305988233727,0.3951410590726619,0.11522834210396547,0.46358747626317165,0.41557904147881863,0.12083348225800945,1,0,1,3,3,1,0
308,119,232,-189,-76,0.442822546914262,0.44162808700160827,0.11554936608412954,0.4815938943866549,0.3775208802349637,0.1408852253783817,0,0,1,1,0,1,0
599,454,611,-145,12,0.4616885221390928,0.41699468352782654,0.12131679433308071,0.38790447296275565,0.45339636699762387,0.1586991600396204,1,1,2,3,4,0,0
309,266,332,-43,23,0.4390745765783024,0.44035466661750233,0.12057075680419531,0.24250800344213067,0.6375062600379545,0.11998573651991493,1,1,3,5,4,0,0
284,221,266,-63,-18,0.45480670703542964,0.4306600531879921,0.11453323977657823,0.4632483031213326,0.4133059016392321,0.12344579523943516,1,0,6,3,2,1,0
358,255,345,-103,-13,0.44840388811526405,0.4359889623686963,0.11560714951603959,0.40834361262405333,0.4608274964649142,0.13082889091103206,1,1,1,1,4,1,0
308,179,224,-129,-84,0.4750792718292623,0.4114031039325244,0.11351762423821342,0.5239101826930104,0.3717581286364844,0.10433168867050538,1,1,1,1,4,1,0
356,334,375,-22,19,0.479610653476673,0.40378809045294956,0.11660125607037758,0.34508686482815665,0.5410355600796358,0.1138775750922074,1,0,1,3,2,0,0
247,321,352,74,105,0.4586867010008493,0.425704684117955,0.11560861488119563,0.4141634551324209,0.46964331205118615,0.11619323281639268,1,1,1,1,4,0,1
522,364,374,-158,-148,0.42320940102614746,0.46714219325548156,0.109648405718371,0.26928378545415615,0.6109569982721706,0.11975921627367334,1,1,1,1,4,1,0
96,0,56,-96,-40,0.4483357945447315,0.43769827378745585,0.11396593166781258,0.4209226864149207,0.4556057845695062,0.1234715290155733,0,1,1,1,1,1,0
217,17,41,-200,-176,0.4447960869387069,0.44200887108444425,0.11319504197684871,0.5046185379764574,0.38497618019578195,0.1104052818277609,0,1,1,1,1,1,0
279,39,126,-240,-153,0.4711898781274946,0.41113726613801604,0.11767285573448949,0.4531814240764875,0.4364202779050084,0.1103982980185042,1,1,1,1,4,1,0
320,263,291,-57,-29,0.47800108360949095,0.40638941351480073,0.1156095028757083,0.4276315638987744,0.44962053017501313,0.12274790592621238,0,1,1,1,1,1,0
253,166,218,-87,-35,0.4528309985064496,0.43443307005277704,0.11273593144077318,0.45921073508306864,0.418829749407079,0.12195951550985223,0,0,2,1,0,1,0
252,94,171,-158,-81,0.4580412327979076,0.42544303070120026,0.1165157365008922,0.4728314237105002,0.40574903203068274,0.12141954425881701,1,1,1,1,4,1,0
117,0,72,-117,-45,0.46534923521447014,0.421663570530648,0.11298719425488181,0.4714308401396948,0.40579247157446224,0.1227766882858431,1,1,1,2,4,1,0
262,209,239,-53,-23,0.43990060694974426,0.449330705302259,0.11076868774799671,0.410367256644237,0.4660716720298462,0.12356107132591691,1,1,1,1,4,1,0
550,327,392,-223,-158,0.4783586808157104,0.39872785611430267,0.12291346306998707,0.28334180993730285,0.5907804275085579,0.12587776255413952,0,1,2,1,1,1,0
291,204,320,-87,29,0.4012720692173284,0.4869736911447384,0.11175423963793323,0.4358083078032162,0.42795613257125026,0.13623555962553333,1,1,1,3,4,0,0
151,0,44,-151,-107,0.4908809147555769,0.3966396014387255,0.11247948380569751,0.4231609558185484,0.45783652258404395,0.1190025215974076,0,0,1,1,0,1,0
296,225,272,-71,-24,0.5003714529261598,0.38259515295239965,0.11703339412144056,0.5130228786911942,0.38203789605096067,0.10493922525784512,0,0,2,1,0,1,0
274,130,173,-144,-101,0.45891524395573813,0.42628311129352686,0.11480164475073498,0.48783460662196554,0.39264070750319624,0.11952468587483805,1,0,2,1,2,1,0
365,378,393,13,28,0.4281236931248789,0.4576301602761484,0.11424614659897284,0.32945821382903384,0.5485786337871748,0.12196315238379142,1,0,5,3,2,0,1
308,233,251,-75,-57,0.4753036400524691,0.4071728423828914,0.11752351756463934,0.39452072852242287,0.49804149267366793,0.10743777880390906,0,1,1,1,1,1,0
381,222,364,-159,-17,0.49623738178650234,0.3823281361296416,0.12143448208385596,0.5713810217516335,0.3192760838478294,0.10934289440053684,0,0,2,1,0,1,0
480,256,361,-224,-119,0.3599997272316628,0.5338940412261148,0.10610623154222214,0.5156300804996102,0.37518144671703824,0.1091884727833518,1,0,1,3,2,1,0
397,312,341,-85,-56,0.47793391542808594,0.4031070019325694,0.11895908263934486,0.2926209539009452,0.6138531835250581,0.09352586257399677,0,0,2,1,0,1,0
446,209,306,-237,-140,0.4622105507850681,0.4280197974492956,0.10976965176563648,0.42879099710684737,0.4607497110856627,0.11045929180749,1,0,1,1,2,1,0
281,309,328,28,47,0.4148576586580756,0.4719556203937348,0.11318672094818952,0.40126277658217435,0.4614686818118959,0.13726854160593005,1,1,1,4,4,0,1
254,227,247,-27,-7,0.4418110265638385,0.4459619793448899,0.1122269940912715,0.47609777580814205,0.408443718330671,0.11545850586118693,0,0,1,1,0,1,0
398,323,358,-75,-40,0.4236546676350534,0.460211431933999,0.11613390043094764,0.43109213387595674,0.4357863426940405,0.13312152343000275,0,0,2,2,0,1,0
338,177,275,-161,-63,0.454240020904526,0.428863025995759,0.11689695309971473,0.4717990142287505,0.40669904832413356,0.12150193744711595,1,0,1,2,2,1,0
654,378,596,-276,-58,0.48366547350806854,0.40153375030227884,0.1148007761896526,0.3321740977663201,0.48908537691895293,0.17874052531472692,0,1,3,1,1,1,0
336,251,277,-85,-59,0.4957854186172835,0.3931008779754311,0.11111370340728524,0.4511022524313786,0.45041720548370373,0.09848054208491754,0,0,1,4,0,1,0
214,130,165,-84,-49,0.5396813857826536,0.34430373447138535,0.11601487974596095,0.4775462413968168,0.3978584270389649,0.12459533156421834,0,1,1,2,1,1,0
326,269,287,-57,-39,0.4448046818229471,0.4421714130038763,0.11302390517317655,0.46971900048929766,0.4332904205754464,0.09699057893525614,0,0,1,1,0,1,0
262,144,308,-118,46,0.3528226061882068,0.5364964520250388,0.11068094178675471,0.35514771304438497,0.527981155114565,0.11687113184105007,0,0,2,1,0,0,0
314,279,345,-35,31,0.41504740993322536,0.46643334068800574,0.11851924937876876,0.42952901813249644,0.4696052426382951,0.10086573922920863,1,1,2,3,4,0,0
240,81,213,-159,-27,0.4480376386993428,0.43819625630235687,0.1137661049983004,0.5090460047481146,0.37771654343189853,0.113237451819987,1,1,1,2,4,1,0
221,0,41,-221,-180,0.4502670798730349,0.4371921664527071,0.11254075367425785,0.445948514491299,0.4531045067561823,0.10094697875251858,0,1,1,1,1,1,0
317,210,224,-107,-93,0.43952997506737035,0.4424559985243784,0.1180140264082512,0.34428260042704745,0.5424391094711604,0.11327829010179205,1,0,1,1,2,1,0
339,275,330,-64,-9,0.4333733359590121,0.45027765249285095,0.11634901154813684,0.4241790787173234,0.4563388499325736,0.11948207135010282,1,1,1,3,4,1,0
357,339,389,-18,32,0.4725753844142174,0.414741522247008,0.11268309333877448,0.4997255771780916,0.40631464472911727,0.09395977809279117,1,1,1,2,4,0,0
367,17,154,-350,-213,0.4447960869387069,0.44200887108444425,0.11319504197684871,0.5046185379764574,0.38497618019578195,0.1104052818277609,1,1,1,1,4,1,0
80,0,40,-80,-40,0.4779868436040933,0.4092304361550912,0.11278272024081545,0.4675059064424861,0.41037536556752036,0.12211872798999336,0,1,1,1,1,1,0
308,278,288,-30,-20,0.45557001681707365,0.43225064178240513,0.11217934140052083,0.4741102723006221,0.39714786940265184,0.12874185829672607,1,0,1,1,3,1,0
450,359,428,-91,-22,0.43007123301206596,0.4543657988182395,0.11556296816969451,0.44256505214025926,0.41563568926047945,0.14179925859926149,0,0,1,1,0,1,0
356,374,393,18,37,0.4543857167746536,0.43432025050494155,0.111294032720405,0.35500425098874233,0.5183439054297382,0.12665184358151943,1,1,3,1,4,0,1
553,515,537,-38,-16,0.3964150007137548,0.4868038670514737,0.11678113223477173,0.32696572661555423,0.5481113559802211,0.12492291740422462,0,0,1,1,0,1,0
349,265,360,-84,11,0.4212628275677563,0.46810424265235534,0.11063292977988828,0.4187272530541631,0.44814547270656846,0.13312727423926846,1,0,2,1,2,0,0
363,307,338,-56,-25,0.43941976580585634,0.44960496742063005,0.11097526677351344,0.41918259523899093,0.462997253766872,0.11782015099413723,0,0,1,2,0,1,0
320,225,288,-95,-32,0.45532338237467895,0.43053206772806774,0.11414454989725326,0.4748552971336351,0.40377810187239643,0.12136660099396858,1,0,2,1,3,1,0
223,287,313,64,90,0.4465356784406648,0.44242800157233303,0.11103631998700238,0.3614200915219094,0.5022049631636595,0.13637494531443115,0,0,1,3,0,0,1
298,308,348,10,50,0.48501393525451303,0.3951507700308671,0.11983529471462,0.40676118860423927,0.481079898252872,0.11215891314288876,1,0,1,2,2,0,1
311,254,273,-57,-38,0.41294773273212376,0.47101770429136747,0.11603456297650915,0.48083203872609304,0.40761219537911514,0.11155576589479163,1,0,1,1,2,1,0
276,315,369,39,93,0.4294417981804208,0.4539841252583973,0.11657407656118188,0.4571403867697144,0.4314267785096675,0.11143283472061812,0,0,1,2,0,0,1
359,240,305,-119,-54,0.41784882722645383,0.4679348634555011,0.11421630931804498,0.3893681190106661,0.4817449617401982,0.1288869192491358,1,0,1,2,3,1,0
425,379,394,-46,-31,0.4605088920705338,0.425046833616966,0.11444427431250001,0.37905844573152764,0.5058583491710996,0.11508320509737241,1,0,1,1,2,1,0
284,295,311,11,27,0.46173165359159674,0.420184328260641,0.1180840181477623,0.28190615545403425,0.5795129702534364,0.1385808742925292,1,0,1,3,2,0,1
531,466,496,-65,-35,0.4314493921660234,0.4478833442319652,0.1206672636020113,0.32740192423429604,0.5347702143304562,0.1378278614352478,1,0,2,1,2,1,0
331,142,170,-189,-161,0.4464012742335674,0.43887560787986,0.11472311788657259,0.49484167226912124,0.4139480334222636,0.09121029430861516,1,1,4,1,4,1,0
296,153,172,-143,-124,0.4398447525865956,0.44773481736043885,0.11242043005296523,0.3868783609611548,0.49067975306178546,0.12244188597705973,0,1,3,2,1,1,0
221,237,252,16,31,0.4434808971310251,0.44382196365777166,0.11269713921120318,0.3349016113825109,0.5571905804667892,0.10790780815069985,1,0,1,1,2,0,1
318,238,289,-80,-29,0.460744161494729,0.4245791836879297,0.11467665481734132,0.45429436312296195,0.4292900746718442,0.11641556220519371,1,0,1,1,2,1,0
317,273,289,-44,-28,0.40178360262319424,0.488410795408568,0.10980560196823809,0.4071824141613775,0.47331778427301585,0.11949980156560622,1,0,1,2,2,1,0
206,219,232,13,26,0.46978071297549645,0.41090040319766163,0.11931888382684211,0.3867012619997579,0.4755303519131319,0.13776838608711026,1,0,3,1,2,0,1
315,240,408,-75,93,0.47783807902090836,0.40858659048695617,0.11357533049213527,0.46408057161629085,0.42521208742287214,0.11070734096083691,0,0,1,1,0,0,0
339,208,220,-131,-119,0.46271627747423066,0.424446026209604,0.11283769631616523,0.5442900452362541,0.3470124848097671,0.10869746995397875,0,0,3,2,0,1,0
391,263,469,-128,78,0.4447960869387069,0.44200887108444425,0.11319504197684871,0.5046185379764574,0.38497618019578195,0.1104052818277609,1,0,1,1,2,0,0
826,763,812,-63,-14,0.4884592848293002,0.3986010180808829,0.11293969708981688,0.47403009814710545,0.4136155833311569,0.11235431852173752,0,1,3,4,1,1,0
306,198,227,-108,-79,0.41232028122014935,0.4774741823876599,0.11020553639219079,0.43202169538463764,0.43901208546806425,0.12896621914729808,1,0,2,2,3,1,0
280,203,234,-77,-46,0.4646587628150408,0.4171255672030188,0.1182156699819402,0.45665066859994285,0.41583000725698305,0.1275193241430742,0,1,1,3,1,1,0
299,244,274,-55,-25,0.44557848662267113,0.4384204423761717,0.11600107100115714,0.4231772769508552,0.45328553022049867,0.12353719282864581,0,0,1,2,0,1,0
310,253,269,-57,-41,0.41930568889579845,0.46852467212857307,0.11216963897562858,0.445901255537908,0.43722456539690935,0.11687417906518248,1,0,1,2,2,1,0
376,125,223,-251,-153,0.4447960869387069,0.44200887108444425,0.11319504197684871,0.5046185379764574,0.38497618019578195,0.1104052818277609,1,1,1,1,4,1,0
473,348,406,-125,-67,0.5802653363087713,0.3021062524518386,0.11762841123938982,0.2551500259495011,0.593738958070655,0.1511110159798436,0,1,2,1,1,1,0
342,262,305,-80,-37,0.4654423219273826,0.4211274420889033,0.11343023598371416,0.4026808597688671,0.4834244834609666,0.11389465677016625,1,1,1,3,4,1,0
54,0,37,-54,-17,0.440748591216016,0.4463386607556237,0.11291274802836022,0.48902339064323125,0.39715229818203635,0.11382431117473257,1,1,1,1,4,1,0
346,242,256,-104,-90,0.471618345398872,0.41549318758860976,0.11288846701251826,0.5284616367601026,0.375571957039487,0.09596640620041036,1,0,2,4,2,1,0
308,272,326,-36,18,0.4759040962717885,0.4091279477592362,0.1149679559689752,0.4688961435133762,0.4214761813132978,0.10962767517332588,1,0,1,2,2,0,0
333,354,395,21,62,0.4799145124758219,0.4055607427484251,0.1145247447757531,0.5053050683851662,0.3797049938738606,0.11498993774097305,0,0,1,3,0,0,1
349,284,315,-65,-34,0.4600873883542883,0.42468450350290443,0.11522810814280722,0.46100628410703887,0.42536134375472046,0.11363237213824048,0,1,1,2,1,1,0
242,141,222,-101,-20,0.44647073816331534,0.43923201835521275,0.11429724348147163,0.4987003361172367,0.39070121318386297,0.11059845069890009,1,0,1,1,3,1,0
298,185,266,-113,-32,0.4751778074414403,0.40829197068100637,0.11653022187755349,0.4397008674287453,0.4504829752428322,0.10981615732842251,0,1,2,1,1,1,0
447,373,469,-74,22,0.38961299414913647,0.48781787816372524,0.12256912768713844,0.32747536803091326,0.5336895873576383,0.13883504461144833,0,1,2,1,1,0,0
299,201,229,-98,-70,0.5129991904239969,0.3717385187994936,0.11526229077650942,0.41752028447040707,0.4810832364597932,0.10139647906979961,0,1,1,1,1,1,0
308,182,250,-126,-58,0.3622471646417124,0.5247752109810415,0.11297762437724607,0.4987226555886395,0.38464778141326544,0.11662956299809522,1,0,4,1,3,1,0
457,256,315,-201,-142,0.46805279970629304,0.41742297463752465,0.11452422565618262,0.46359118584053277,0.4302474719265319,0.10616134223293529,1,1,1,2,4,1,0
377,0,224,-377,-153,0.46787666076250806,0.4196469508834413,0.11247638835405067,0.5047106476797759,0.38293553250409207,0.11235381981613213,0,0,1,1,0,1,0
311,274,296,-37,-15,0.4479538571724429,0.4403614093239709,0.11168473350358661,0.4084612108632371,0.49173090369268707,0.09980788544407586,1,0,1,3,2,1,0
297,248,283,-49,-14,0.47083718842878747,0.4169277998491149,0.11223501172209789,0.4405281911039751,0.4551763433172209,0.10429546557880397,1,0,1,1,2,1,0
318,243,296,-75,-22,0.4412741616393529,0.44467683411750375,0.11404900424314302,0.4330408884956172,0.4345889636470468,0.1323701478573356,0,0,1,1,0,1,0
146,111,137,-35,-9,0.4629034727361232,0.42385470545382004,0.11324182181005704,0.46532349671676954,0.42273938062598243,0.11193712265724799,1,1,1,2,4,1,0
284,252,263,-32,-21,0.44392516139521415,0.4377889949112907,0.11828584369349521,0.46167785110557724,0.43174046269389305,0.1065816862005297,0,0,1,1,0,1,0
350,304,324,-46,-26,0.49173725120622863,0.39176121213753656,0.11650153665623489,0.4404643461104034,0.4407525121073049,0.1187831417822917,1,0,2,1,2,1,0
230,175,217,-55,-13,0.4759297949714643,0.4116867654721442,0.1123834395563913,0.4247591489341892,0.46770877932586363,0.10753207173994712,0,1,1,3,1,1,0
238,177,201,-61,-37,0.4439942798289641,0.44717392524157584,0.10883179492945996,0.34587692708080836,0.5473768683654476,0.10674620455374394,0,0,1,1,0,1,0
282,234,240,-48,-42,0.40288774527835963,0.47977204526026496,0.11734020946137552,0.2748423394377699,0.5746522970292114,0.15050536353301885,0,0,1,2,0,1,0
238,182,210,-56,-28,0.4328736033583945,0.45628452137312764,0.11084187526847766,0.37542282917638536,0.5216281503679474,0.10294902045566691,1,1,1,1,4,1,0
294,319,340,25,46,0.4361418802370961,0.451845022732866,0.11201309703003785,0.40942707729240946,0.46628992719276685,0.12428299551482368,0,1,3,1,1,0,1
448,339,399,-109,-49,0.4870450071923514,0.3937442162358234,0.11921077657182522,0.464831585842596,0.42756016465407887,0.10760824950332505,1,0,1,1,2,1,0
305,152,238,-153,-67,0.47668390128777266,0.4104305737268448,0.11288552498538229,0.34514667081072437,0.5310539155258857,0.12379941366338985,0,1,1,1,1,1,0
260,144,239,-116,-21,0.4419749707277084,0.4465402685820583,0.11148476069023332,0.46068425026512844,0.4260847901687818,0.11323095956608956,1,0,1,1,2,1,0
337,215,269,-122,-68,0.4413440722171521,0.44183024709454727,0.1168256806883006,0.4946589582588674,0.38139784463966053,0.1239431971014722,0,0,1,1,0,1,0
348,380,443,32,95,0.45078948019886766,0.43942780793327646,0.10978271186785575,0.435173105750166,0.4474642944991037,0.11736259975073038,0,1,2,4,1,0,1
282,242,268,-40,-14,0.41193043099643306,0.47527217722901993,0.11279739177454692,0.47204335110262735,0.40466505965512467,0.12329158924224766,1,1,1,4,4,1,0
313,169,231,-144,-82,0.41125020919136585,0.4730854604837913,0.1156643303248428,0.3257730349052346,0.5494570536915868,0.12476991140317874,0,1,1,1,1,1,0
344,235,290,-109,-54,0.4314324801256523,0.45454529013177647,0.11402222974257128,0.3004515898151847,0.5888771969477116,0.11067121323710355,0,0,2,1,0,1,0
292,58,85,-234,-207,0.4447960869387069,0.44200887108444425,0.11319504197684871,0.5046185379764574,0.38497618019578195,0.1104052818277609,0,1,1,1,1,1,0
267,309,367,42,100,0.46243501283362215,0.42038448211053386,0.11718050505584424,0.3365383266044536,0.5456111211375847,0.11785055225796168,1,1,2,1,4,0,1
284,169,219,-115,-65,0.42153433685077696,0.4654600797646197,0.11300558338460338,0.44986358854734315,0.4245748236360882,0.1255615878165683,0,1,2,3,1,1,0
270,151,280,-119,10,0.46379895307929997,0.4210447222361607,0.11515632468453929,0.49162108345472905,0.39686207487589065,0.11151684166937999,1,1,1,1,4,0,0
275,304,332,29,57,0.4801557756640436,0.40178533890786106,0.11805888542809546,0.42642894949134985,0.43760592859187,0.13596512191678015,1,0,3,1,2,0,1
313,254,272,-59,-41,0.4494991457658419,0.4361562072286574,0.11434464700550076,0.4343130363481314,0.4521925322699633,0.11349443138190515,1,1,1,1,4,1,0
372,303,334,-69,-38,0.44630611542855525,0.43828516503317844,0.11540871953826601,0.39574334849925663,0.5060125397316478,0.09824411176909563,1,1,2,2,4,1,0
293,206,214,-87,-79,0.4462897131838822,0.4393529259532835,0.1143573608628341,0.5118888741759439,0.3718454222666638,0.11626570355739237,1,0,2,1,3,1,0
223,91,162,-132,-61,0.5061372685527488,0.37895968521706974,0.11490304623018154,0.41712456779620105,0.4600982124855266,0.12277721971827224,0,0,2,1,0,1,0
434,235,267,-199,-167,0.4708736985758026,0.4120231411965043,0.11710316022769293,0.3094431327953376,0.5896935688133341,0.10086329839132809,1,0,1,5,2,1,0
377,232,282,-145,-95,0.42716034841005224,0.4616873852621072,0.11115226632784052,0.4204592622406335,0.47550210295729034,0.10403863480207591,1,1,2,3,4,1,0
398,448,521,50,123,0.43053089632222713,0.45493839889547105,0.11453070478230179,0.4599933763199808,0.4141049134402244,0.12590171023979482,0,1,5,5,1,0,1
250,204,260,-46,10,0.454883338402132,0.43013212508187143,0.11498453651599694,0.3325068047846874,0.5518167807852649,0.11567641443004764,1,0,1,3,2,0,0
396,219,357,-177,-39,0.4673213376665612,0.4151327306659832,0.11754593166745576,0.4875373258238917,0.3861761473152347,0.12628652686087358,1,0,2,1,2,1,0
352,283,334,-69,-18,0.384507424397105,0.5070935617036655,0.1083990138992296,0.39389480278907285,0.4850142190524233,0.12109097815850363,0,1,1,1,1,1,0
276,225,297,-51,21,0.46992952210726463,0.4152916255250862,0.11477885236764904,0.4303886417766886,0.4605007054926666,0.10911065273064474,1,1,1,1,4,0,0
264,284,312,20,48,0.44788494107271215,0.435503761494042,0.11661129743324591,0.4278689511616875,0.4492545477510808,0.12287650108723182,1,0,4,1,2,0,1
229,263,292,34,63,0.41352468465740483,0.4756147270425329,0.11086058830006254,0.3939725125474258,0.49061481098139154,0.11541267647118235,1,0,4,2,3,0,1
361,298,320,-63,-41,0.4431115493138394,0.4445844223409026,0.11230402834525786,0.48561254139616983,0.4014391982433768,0.11294826036045347,1,0,4,2,2,1,0
321,176,267,-145,-54,0.4545862403793245,0.4306258332149994,0.11478792640567596,0.37045185684775717,0.509441714830831,0.12010642832141158,1,0,2,1,3,1,0
392,350,377,-42,-15,0.4874704094392186,0.39587139769467583,0.11665819286610565,0.38172067222768946,0.48560189603402476,0.13267743173828575,1,0,3,2,2,1,0
290,195,262,-95,-28,0.3900157826077768,0.49989533584287976,0.11008888154934349,0.5242397933290336,0.36387611485699795,0.11188409181396831,0,0,1,1,0,1,0
254,181,199,-73,-55,0.44885131523646077,0.43697240756258887,0.11417627720095068,0.5034041216223303,0.3920935703061445,0.10450230807152519,1,0,1,2,3,1,0
5,105,167,100,162,0.4447960869387069,0.44200887108444425,0.11319504197684871,0.5046185379764574,0.38497618019578195,0.1104052818277609,1,1,1,1,4,0,1
395,406,490,11,95,0.45353737534064426,0.4325748412655845,0.1138877833937715,0.4904270752078587,0.4012965176207798,0.10827640717136146,1,0,1,1,2,0,1
272,161,246,-111,-26,0.44315717086423845,0.447540310406771,0.1093025187289907,0.44751762357125624,0.42663052389418776,0.12585185253455572,0,0,1,2,0,1,0
302,41,98,-261,-204,0.41842543217126826,0.4706941344426697,0.11088043338606177,0.4691876532392265,0.4223676967010013,0.108444650059772,1,0,1,2,2,1,0
254,171,321,-83,67,0.44595385085298733,0.4402040582550166,0.1138420908919962,0.49533281704045645,0.39527564756413613,0.10939153539540754,1,0,1,1,2,0,0
561,421,488,-140,-73,0.4382974689604098,0.4383779069426283,0.12332462409696196,0.4641359858903378,0.3849737359556168,0.1508902781540457,1,0,3,1,2,1,0
524,397,420,-127,-104,0.41231428457967284,0.4764488412423349,0.1112368741779923,0.45216068576886576,0.43154160769948285,0.11629770653165111,0,0,3,1,0,1,0
343,282,334,-61,-9,0.4459450051232324,0.44110808077559505,0.11294691410117236,0.3680116833605047,0.5040739269346238,0.12791438970487176,1,0,1,2,2,1,0
303,261,276,-42,-27,0.4387931385350128,0.453452188632485,0.10775467283250222,0.4762528383675955,0.41052098743617804,0.11322617419622645,0,0,1,3,0,1,0
332,236,290,-96,-42,0.3832443508351212,0.505123244482916,0.11163240468196281,0.4812076760075462,0.40114694319102917,0.1176453808014246,1,0,1,1,2,1,0
205,174,195,-31,-10,0.47769589034351456,0.4016831349983673,0.12062097465811819,0.5721309391615056,0.3183927053105082,0.10947635552798626,1,0,1,1,2,1,0
286,309,365,23,79,0.508053493708789,0.37789592829517044,0.11405057799604053,0.4283792587418728,0.4563600603900981,0.11526068086802879,1,0,1,2,2,0,1
263,157,244,-106,-19,0.45730698963921046,0.42958680306725483,0.11310620729353489,0.4468953184121798,0.44068836424367896,0.11241631734414098,1,1,2,2,4,1,0
368,301,327,-67,-41,0.4689578863088726,0.4165799960138301,0.11446211767729723,0.3884671763945161,0.48874211029560016,0.12279071330988384,1,1,1,1,4,1,0
502,576,599,74,97,0.40434752523993,0.4848280650814348,0.11082440967863506,0.3797379637477655,0.5201634503154211,0.10009858593681305,1,0,1,3,2,0,1
262,273,314,11,52,0.5195308725982742,0.36774742534876775,0.11272170205295833,0.5389707646035419,0.3466859217318763,0.11434331366458192,1,1,1,1,4,0,1
517,343,406,-174,-111,0.49132654846309004,0.39067659618904216,0.1179968553478677,0.24115970930292643,0.6200853326635197,0.13875495803355373,0,1,1,1,1,1,0
244,258,270,14,26,0.47291768716136334,0.41149813770587207,0.11558417513276469,0.4311444427599399,0.4479592496211309,0.12089630761892915,1,0,1,1,2,0,1
295,166,251,-129,-44,0.44185792435944315,0.4475150234563033,0.1106270521842537,0.44686134787569687,0.4337769399350841,0.11936171218921914,0,1,2,1,1,1,0
344,383,447,39,103,0.45815139223835094,0.42909387152569717,0.1127547362359518,0.43314127460956103,0.43377510283499965,0.13308362255543932,1,0,2,2,2,0,1
399,223,318,-176,-81,0.535016003374553,0.3449282116276167,0.12005578499783048,0.3549277628298019,0.5253464419967901,0.11972579517340808,0,0,1,3,0,1,0
233,0,170,-233,-63,0.5051011543784754,0.3772087278099463,0.11769011781157811,0.5017677116639726,0.3792186160529795,0.11901367228304786,0,1,1,1,1,1,0
289,99,138,-190,-151,0.4560705853102379,0.4283881267194418,0.11554128797032025,0.4744057417109377,0.4161416093675315,0.10945264892153081,0,1,1,2,1,1,0
327,194,249,-133,-78,0.4646707114194816,0.42578641702934167,0.10954287155117684,0.4662313480368022,0.41924483670700585,0.11452381525619178,0,1,2,1,1,1,0
91,0,75,-91,-16,0.4242770858790824,0.4638099999202771,0.11191291420064045,0.4989468200007463,0.39180085331694264,0.10925232668231133,0,1,1,1,1,1,0
296,150,219,-146,-77,0.4498869240328075,0.4357293145299371,0.11438376143725536,0.30839306746275985,0.5590858250372652,0.13252110749997456,0,0,1,1,0,1,0
316,261,286,-55,-30,0.4243367846027103,0.46278792382638745,0.11287529157090251,0.3918789888198214,0.4779139861081726,0.1302070250720061,0,0,2,3,0,1,0
356,230,332,-126,-24,0.4279201197425127,0.461981673811784,0.11009820644570364,0.42825809180346963,0.4359529009221875,0.13578900727434284,1,0,1,1,2,1,0
365,236,473,-129,108,0.4118123767847714,0.4785099157343384,0.10967770748089048,0.4247494529467121,0.4638584795686756,0.11139206748461228,1,0,1,3,3,0,0
364,294,316,-70,-48,0.4275419787838131,0.45525396545991326,0.11720405575627359,0.3408601786302937,0.5378896761705454,0.12125014519916072,0,1,1,1,1,1,0
262,241,318,-21,56,0.46570196004567405,0.42178453713579844,0.11251350281852761,0.3275882432449258,0.541307435368251,0.1311043213868231,1,1,1,1,4,0,0
277,303,359,26,82,0.48611780049476067,0.39939999378010305,0.1144822057251364,0.4392066785744566,0.43547511809469414,0.12531820333084914,1,0,2,1,2,0,1
397,0,71,-397,-326,0.44317004723622894,0.43914677766496785,0.1176831750988035,0.45357838896748454,0.4113848702647654,0.13503674076774982,0,1,2,1,1,1,0
377,275,348,-102,-29,0.4319587955201947,0.44940787033170176,0.11863333414810356,0.43452996717918857,0.4482871208126537,0.1171829120081575,0,0,3,1,0,1,0
305,265,292,-40,-13,0.4476599025641059,0.4379219331342393,0.11441816430165462,0.4027537653498771,0.48820707687533504,0.10903915777478798,1,1,3,3,4,1,0
367,254,453,-113,86,0.45216780538506385,0.43309695544788424,0.11473523916705212,0.5609376442816372,0.30852436240792797,0.1305379933104347,1,0,1,2,2,0,0
322,157,296,-165,-26,0.45294794446677095,0.43573927459388795,0.11131278093934108,0.3824572137626361,0.5047759174418044,0.11276686879555983,0,0,2,1,0,1,0
561,574,668,13,107,0.37399132364559523,0.5130954521627886,0.11291322419161619,0.33485370115071267,0.5336416792817763,0.13150461956751078,1,0,2,1,2,0,1
308,254,289,-54,-19,0.4366816534520874,0.4464009525560765,0.11691739399183607,0.46714263572886394,0.41903872445098356,0.11381863982015246,0,0,1,1,0,1,0
280,132,192,-148,-88,0.5452632274950472,0.3373064752912672,0.11743029721368549,0.47036224658301795,0.40266513100554274,0.1269726224114393,0,1,1,1,1,1,0
259,248,441,-11,182,0.44287601902840046,0.4451357248560838,0.11198825611551609,0.46150593151273517,0.4288642642042433,0.1096298042830215,0,1,1,2,1,0,0
358,264,470,-94,112,0.46779306049946273,0.4216482559502585,0.11055868355027898,0.38695453171446526,0.4740175370883525,0.13902793119718226,0,0,1,1,0,0,0
302,184,215,-118,-87,0.44552931681867736,0.4401957524417599,0.1142749307395625,0.27217742730810185,0.6196371069154123,0.10818546577648597,0,0,1,2,0,1,0
321,258,309,-63,-12,0.44331621651277675,0.4424037144137629,0.11428006907346018,0.4108005320787561,0.4422538593439239,0.14694560857732003,1,1,1,4,4,1,0
333,264,306,-69,-27,0.41019794416208827,0.4768783436125015,0.11292371222541037,0.36098670916121406,0.5117958997085981,0.1272173911301879,0,0,3,3,0,1,0
281,322,358,41,77,0.4447960869387069,0.44200887108444425,0.11319504197684871,0.5046185379764574,0.38497618019578195,0.1104052818277609,1,1,3,2,4,0,1
337,250,306,-87,-31,0.4359072129752568,0.4546024500048885,0.10949033701985444,0.46161813544263586,0.4432264891269548,0.09515537543040928,0,1,3,1,1,1,0
584,522,565,-62,-19,0.4029389591769209,0.48779768375932436,0.10926335706375469,0.3667217043741734,0.5214474308898932,0.11183086473593327,0,0,1,4,0,1,0
471,377,398,-94,-73,0.41904541512934446,0.46849438712729063,0.11246019774336537,0.43117854486373647,0.44296968879514664,0.12585176634111664,1,0,1,4,3,1,0
409,367,383,-42,-26,0.4918203549508084,0.38626793810886606,0.12191170694032546,0.3890691060021641,0.49053614329723727,0.12039475070059853,1,0,1,1,2,1,0
286,244,256,-42,-30,0.458612209107927,0.4290075493407858,0.11238024155128735,0.48517280151851067,0.386477638389585,0.12834956009190454,1,1,3,2,4,1,0
408,324,374,-84,-34,0.4113822811753499,0.4736578050781939,0.11495991374645609,0.45268314199814,0.4322377415300272,0.1150791164718327,0,1,3,2,1,1,0
300,262,275,-38,-25,0.45518218344646927,0.4313635594721326,0.1134542570813983,0.4503122176510437,0.42414370207927343,0.1255440802696828,1,1,1,2,4,1,0
514,457,569,-57,55,0.4855066197535057,0.3935550292023849,0.1209383510441094,0.35175116180432736,0.512211054886705,0.13603778330896754,0,1,2,2,1,0,0
307,219,244,-88,-63,0.5418809169525001,0.3413644470582922,0.1167546359892075,0.4584626625890951,0.43416287509600254,0.10737446231490261,0,1,1,2,1,1,0
274,220,247,-54,-27,0.4988562573863427,0.38667832604966135,0.11446541656399578,0.5155800333720978,0.3868254365271264,0.09759453010077551,1,1,1,1,4,1,0
324,263,312,-61,-12,0.4173882246046854,0.4703467857760222,0.11226498961929261,0.302213449598486,0.5575357060531508,0.14025084434836296,0,0,2,2,0,1,0
302,205,246,-97,-56,0.4675865723028373,0.42241754206735893,0.10999588562980364,0.396575979627312,0.48635919683620704,0.11706482353648098,0,1,1,2,1,1,0
408,244,299,-164,-109,0.44505349344644585,0.43765978878963063,0.11728671776392365,0.360307860442624,0.5145073285436026,0.1251848110137733,0,0,1,3,0,1,0
361,288,312,-73,-49,0.46192353576566836,0.42425549921589806,0.11382096501843364,0.5052534587971422,0.39215684833841735,0.10258969286444032,0,0,2,1,0,1,0
145,33,85,-112,-60,0.47876540800747674,0.403561779856272,0.11767281213625087,0.45339650388524316,0.43995861226117516,0.10664488385358152,0,1,1,1,1,1,0
327,339,398,12,71,0.44781421364085333,0.43928561347444695,0.1129001728846994,0.37675934017281654,0.4867574134200071,0.13648324640717618,1,0,1,1,2,0,1
326,226,243,-100,-83,0.455843134223568,0.4308548011135184,0.11330206466291358,0.39908304537263883,0.4764787940168446,0.12443816061051614,0,1,2,2,1,1,0
325,302,344,-23,19,0.45263056377056726,0.4361887624735886,0.11118067375584394,0.3718220308054586,0.5271659033107283,0.10101206588381309,1,1,1,2,4,0,0
271,232,246,-39,-25,0.4430483395185989,0.4437176361651631,0.11323402431623814,0.4399293439785056,0.44464605593462236,0.11542460008687168,1,1,1,2,4,1,0
108,7,77,-101,-31,0.4447960869387069,0.44200887108444425,0.11319504197684871,0.5046185379764574,0.38497618019578195,0.1104052818277609,0,1,1,1,1,1,0
301,317,337,16,36,0.43919059604702604,0.4493650879804252,0.11144431597254902,0.40414127691211993,0.47649741628752196,0.11936130680035821,1,0,2,1,2,0,1
249,0,127,-249,-122,0.3999863754630474,0.4858214848029229,0.11419213973402943,0.392182733502901,0.48462079066819436,0.12319647582890457,0,1,1,2,1,1,0
263,234,244,-29,-19,0.4515186587807662,0.43317432147310697,0.11530701974612695,0.4603451038604306,0.40258955283408704,0.1370653433054825,1,1,3,1,4,1,0
266,207,225,-59,-41,0.42320035449598126,0.46546663125936455,0.11133301424465411,0.519496124915763,0.3628109880831519,0.11769288700108503,1,1,1,2,4,1,0
343,239,272,-104,-71,0.45796927223230705,0.429763971877933,0.11226675588975989,0.4078558996737558,0.47724856109468133,0.11489553923156276,1,0,1,1,3,1,0
309,279,335,-30,26,0.42560664841473056,0.4656353455239543,0.10875800606131514,0.4440957709933649,0.43406070067016517,0.12184352833646982,1,0,1,1,2,0,0
304,190,271,-114,-33,0.453139501137243,0.4326970507768981,0.11416344808585896,0.48382329861239676,0.40419080772837884,0.11198589365922429,1,0,1,1,2,1,0
332,287,317,-45,-15,0.4178398058439156,0.4686350767640746,0.11352511739200977,0.4676273602305103,0.423621644978027,0.10875099479146254,1,0,1,2,3,1,0
360,22,232,-338,-128,0.4788648114163639,0.4021164869746799,0.11901870160895617,0.3443553740103555,0.5318232388005183,0.12382138718912644,1,1,1,1,4,1,0
296,265,282,-31,-14,0.4543935120014297,0.4336994603997695,0.11190702759880072,0.3220383408361219,0.5420324009068684,0.13592925825700955,1,1,1,3,4,1,0
276,211,346,-65,70,0.4880994203594976,0.39947489475230186,0.11242568488820064,0.4864631251571628,0.3874187085626749,0.12611816628016254,1,0,2,1,2,0,0
443,347,411,-96,-32,0.443872389015116,0.4439633062177419,0.1121643047671419,0.41531896512313615,0.4523366607691526,0.1323443741077114,0,0,1,1,0,1,0
173,109,125,-64,-48,0.4712145737004038,0.40771765093607654,0.12106777536351943,0.3602994891764404,0.49894766059919626,0.14075285022436337,0,1,2,1,1,1,0
254,266,307,12,53,0.4867167653095647,0.4021544215101601,0.11112881318027495,0.4649258034956762,0.4342186802690473,0.10085551623527637,0,0,1,1,0,0,1
415,289,313,-126,-102,0.43215691327132977,0.45350051080228987,0.11434257592638007,0.4256296210656146,0.4415067632918284,0.1328636156425568,0,0,2,3,0,1,0
312,185,363,-127,51,0.4494179425775839,0.44289697446482185,0.1076850829575943,0.4202236166417795,0.44147781828733046,0.13829856507088975,1,0,1,1,2,0,0
465,349,396,-116,-69,0.3510313650198023,0.5352478959096475,0.1137207390705499,0.22454707173136912,0.6306957267459221,0.14475720152270888,0,0,3,1,0,1,0
343,34,88,-309,-255,0.43801213741522327,0.44966932580161334,0.1123185367831634,0.44283377160417425,0.45021564417052906,0.10695058422529649,0,0,1,1,0,1,0
131,0,61,-131,-70,0.43891834504388655,0.4432366529706821,0.11784500198543107,0.4627128235374325,0.42655340115823315,0.1107337753043345,0,1,1,1,1,1,0
502,0,41,-502,-461,0.511766270695644,0.37053555395867693,0.11769817534567914,0.4725917598907634,0.4148007129572246,0.11260752715201162,0,1,1,1,1,1,0
265,119,199,-146,-66,0.47080864900498354,0.4089873565329229,0.12020399446209347,0.4233211120844743,0.4605017336720622,0.11617715424346335,0,1,1,1,1,1,0
321,255,284,-66,-37,0.432892730466129,0.4549778677002974,0.11212940183357367,0.32990295037959017,0.5426292015659736,0.12746784805443617,0,0,1,3,0,1,0
426,226,405,-200,-21,0.44685429543489463,0.4348730365175973,0.11827266804750768,0.37114558269939973,0.5131329359255401,0.11572148137506041,1,0,1,1,2,1,0
296,176,258,-120,-38,0.4350154883122256,0.44932672810133006,0.1156577835864443,0.46860307877866764,0.41099033208118213,0.12040658914015018,0,1,1,1,1,1,0
268,156,178,-112,-90,0.4447960869387069,0.44200887108444425,0.11319504197684871,0.5046185379764574,0.38497618019578195,0.1104052818277609,1,1,1,1,4,1,0
282,290,389,8,107,0.46601910021227394,0.41718992455505444,0.1167909752326716,0.48443586181552045,0.3981289965573627,0.11743514162711678,1,0,1,1,2,0,1
254,354,476,100,222,0.45606072813029486,0.4308369022160108,0.11310236965369415,0.4225071793786641,0.4604051040041031,0.11708771661723279,1,1,3,1,4,0,1
330,266,307,-64,-23,0.34866720762373027,0.5378298167427946,0.11350297563347506,0.31612304624502685,0.57021394177834,0.11366301197663332,0,0,1,1,0,1,0
614,438,548,-176,-66,0.4430079546582651,0.4405969808692653,0.11639506447246965,0.32495855480665475,0.5652870175120818,0.1097544276812635,1,0,1,3,2,1,0
340,203,212,-137,-128,0.41249239807187993,0.47337787467542825,0.11412972725269184,0.4127533626964781,0.4584884830085645,0.12875815429495713,1,1,1,1,4,1,0
335,284,318,-51,-17,0.4254205542249066,0.45830962489904686,0.11626982087604645,0.42215198787234615,0.43634868263827925,0.14149932948937435,0,1,2,2,1,1,0
504,398,455,-106,-49,0.5772936524869818,0.3046672299965078,0.11803911751651038,0.394315472378547,0.482385216444065,0.12329931117738792,0,1,2,1,1,1,0
239,156,212,-83,-27,0.49439855559448975,0.3911211061458907,0.1144803382596197,0.5075359660460775,0.37678608423637105,0.11567794971755105,1,1,1,2,4,1,0
392,242,340,-150,-52,0.4113447128669291,0.47445586130840733,0.11419942582466336,0.42225796510645597,0.44266989821800534,0.13507213667553888,1,0,1,2,2,1,0
285,187,266,-98,-19,0.46384092899062995,0.4232910750509974,0.11286799595837257,0.4552820563381033,0.41425313357383126,0.13046481008806554,0,1,2,1,1,1,0
282,367,392,85,110,0.48698925473532706,0.39861617036655,0.11439457489812296,0.34071905158799615,0.515402026294053,0.14387892211795109,0,0,1,1,0,0,1
324,375,445,51,121,0.4336288990637569,0.4507624351446207,0.11560866579162257,0.4118169017175183,0.4772185684272586,0.11096452985522283,0,0,4,2,0,0,1
400,298,309,-102,-91,0.5146514738157902,0.36938153763871423,0.11596698854549556,0.2758466105681003,0.5770381259624852,0.14711526346941445,0,0,3,1,0,1,0
441,461,502,20,61,0.42340000623846713,0.4616773360153972,0.11492265774613575,0.44056280796945085,0.44542991089185907,0.11400728113869005,1,0,3,1,2,0,1
148,99,124,-49,-24,0.440639081056071,0.44722315575739363,0.11213776318653498,0.47779463741979256,0.41161801446380303,0.11058734811640435,0,0,2,2,0,1,0
189,0,75,-189,-114,0.47163666696617856,0.41426707851328387,0.11409625452053762,0.410867362279646,0.4796698915216332,0.10946274619872087,0,0,1,1,0,1,0
182,80,102,-102,-80,0.48386949312754857,0.4040714977129751,0.11205900915947618,0.4409884760263077,0.4423410796096803,0.11667044436401203,0,0,1,2,0,1,0
276,223,257,-53,-19,0.4250757387727579,0.46091358930096704,0.11401067192627508,0.32552332476003304,0.5636784285372519,0.11079824670271508,1,0,3,1,2,1,0
372,279,307,-93,-65,0.42837135761597395,0.45529901516970595,0.11632962721432032,0.3973523420726939,0.48356297781594865,0.11908468011135735,1,0,1,1,2,1,0
369,316,337,-53,-32,0.3811906567468676,0.5015835217015457,0.1172258215515866,0.4327955658448018,0.43762517532463835,0.12957925883055985,1,0,1,1,2,1,0
331,213,225,-118,-106,0.42834847369382656,0.4578097498592912,0.11384177644688191,0.4847624817881654,0.3994378770702021,0.11579964114163281,1,1,2,1,4,1,0
317,209,278,-108,-39,0.3916951118346397,0.49261801865622423,0.11568686950913624,0.29355650924298143,0.5843099906088177,0.12213350014820067,0,0,3,1,0,1,0
382,53,206,-329,-176,0.44696921457733824,0.43652685255345464,0.116503932869207,0.38942882223666286,0.4759558365574872,0.13461534120585006,1,0,1,1,2,1,0
353,184,292,-169,-61,0.5324285112632953,0.3537670696858142,0.1138044190508906,0.4493911446692634,0.42304309765238685,0.12756575767834968,0,0,1,2,0,1,0
409,207,471,-202,62,0.45717781161327264,0.42863166957038795,0.11419051881633932,0.366324912423011,0.4992544716216092,0.1344206159553798,0,0,1,1,0,0,0
325,260,285,-65,-40,0.48666864012783356,0.4037132615086766,0.10961809836348989,0.4491373057768199,0.45249153931957264,0.0983711549036071,0,1,2,1,1,1,0
338,251,258,-87,-80,0.4049857556794646,0.4774367380941115,0.11757750622642354,0.4544792334090617,0.4367212743558766,0.10879949223506145,0,1,1,1,1,1,0
359,315,345,-44,-14,0.37853035551169856,0.5046188041709161,0.11685084031738564,0.4364220344994496,0.4496759564439014,0.11390200905664875,1,0,2,1,3,1,0
292,184,259,-108,-33,0.4285096140370839,0.454383570293442,0.11710681566947408,0.4520129560859534,0.4340293963552742,0.11395764755877223,0,1,2,2,1,1,0
262,194,277,-68,15,0.4012135884223034,0.48954538466785585,0.10924102690984062,0.4602681233942148,0.41970486485652597,0.12002701174925914,1,0,1,1,2,0,0
314,238,280,-76,-34,0.47002335897440634,0.41732040825789307,0.11265623276770073,0.5327868925419104,0.36617646372733986,0.1010366437307499,1,1,1,1,4,1,0
538,467,507,-71,-31,0.4239078026930917,0.4683562046199248,0.10773599268698343,0.34109812438471315,0.5371420349538144,0.1217598406614724,1,0,1,3,2,1,0
199,110,127,-89,-72,0.5017872394217435,0.38097889883661634,0.11723386174164023,0.510771270324394,0.3768328496346216,0.11239588004098416,0,1,1,1,1,1,0
328,249,310,-79,-18,0.4557921198375705,0.4298143555422,0.11439352462022924,0.3813361497498523,0.5096945645785634,0.10896928567158407,1,0,1,3,3,1,0
614,409,542,-205,-72,0.44155041842263476,0.4417215166067626,0.11672806497060258,0.3488152659982346,0.5216578271776046,0.12952690682416068,1,0,4,2,2,1,0
319,225,250,-94,-69,0.4762334971134829,0.4090695310368534,0.11469697184966353,0.5253002642442602,0.35437530528166156,0.12032443047407822,1,0,1,1,3,1,0
307,217,244,-90,-63,0.3915073469634918,0.4931017253931457,0.11539092764336224,0.542219189116167,0.3470723336066365,0.11070847727719654,0,0,2,2,0,1,0
345,287,318,-58,-27,0.41078375518996546,0.4791429311209343,0.11007331368910041,0.4286378388325898,0.44801280174256564,0.12334935942484455,1,0,1,2,2,1,0
266,187,216,-79,-50,0.47104747694174626,0.4140171862293227,0.1149353368289313,0.41707697502362473,0.47175312731131025,0.11116989766506483,0,0,1,1,0,1,0
421,295,315,-126,-106,0.434397256656919,0.4512702215643952,0.11433252177868618,0.49452636507250936,0.3863467766072806,0.11912685832021003,1,1,1,1,4,1,0
350,264,342,-86,-8,0.5745091092807469,0.30744670305599875,0.11804418766325467,0.44982776411727055,0.40331552739544757,0.14685670848728202,0,1,1,1,1,1,0
347,234,299,-113,-48,0.45018987014236506,0.4336762855984867,0.11613384425914824,0.4696473240032377,0.4134922586895827,0.11686041730717942,1,0,2,1,2,1,0
141,314,385,173,244,0.45963075697094863,0.42850866468907534,0.11186057833997606,0.4609336358349906,0.4200665315710072,0.11899983259400221,1,0,2,1,2,0,1
312,286,338,-26,26,0.437473159699114,0.4451454507843462,0.1173813895165398,0.4196495094032705,0.4549541753300601,0.12539631526666947,1,1,2,2,4,0,0
374,292,402,-82,28,0.40176458731801434,0.48335015980274354,0.11488525287924187,0.3258948689105303,0.5451651502870927,0.12893998080237662,1,0,2,1,2,0,0
444,380,433,-64,-11,0.4656853870354665,0.4135943051629121,0.12072030780162112,0.3268718035291195,0.5506163055303513,0.12251189094052879,0,0,1,1,0,1,0
374,196,360,-178,-14,0.42655129027629074,0.45563744357232666,0.11781126615138242,0.4374286323287526,0.44508119709099336,0.11749017058025384,0,0,1,1,0,1,0
317,374,410,57,93,0.36431089851197773,0.5188530474332795,0.11683605405474286,0.40966254916214345,0.48551384546540116,0.10482360537245518,0,0,2,1,0,0,1
280,189,246,-91,-34,0.41349301375788217,0.47253334356737386,0.1139736426747439,0.4186203380734512,0.45601549865770535,0.12536416326884323,1,1,2,1,4,1,0
351,28,305,-323,-46,0.5190378677574962,0.366096756967609,0.1148653752748949,0.37223973820094197,0.49263906107636535,0.13512120072269276,0,0,1,1,0,1,0
408,322,350,-86,-58,0.5057560976626029,0.378146746307712,0.11609715602968516,0.3505313163614793,0.5438436180817519,0.1056250655567689,1,0,1,1,2,1,0
460,273,360,-187,-100,0.3931420843751937,0.49041521937518534,0.1164426962496209,0.3385241225219255,0.5298089500960255,0.13166692738204913,0,1,4,1,1,1,0
507,365,398,-142,-109,0.4863665679358296,0.3988176203966085,0.11481581166756173,0.3584725503458858,0.5268467437928291,0.11468070586128504,0,1,1,2,1,1,0
407,419,442,12,35,0.4313162878840329,0.45583575156631856,0.1128479605496489,0.451078115524369,0.4213423625016913,0.1275795219739395,1,0,1,2,2,0,1
383,293,361,-90,-22,0.4378013101035441,0.44770573230508803,0.11449295759136736,0.31670409821496487,0.55676958560983,0.1265263161752049,1,0,1,2,3,1,0
345,253,260,-92,-85,0.4258388927223158,0.45681127707515395,0.11734983020253012,0.45672901759844414,0.43648168012322036,0.10678930227833566,1,0,1,2,3,1,0
276,205,246,-71,-30,0.43838532479087844,0.4491999102708096,0.11241476493831204,0.4724476571808801,0.41701325033219006,0.11053909248692961,1,0,2,2,2,1,0
307,322,333,15,26,0.45218257133338435,0.43186295217806037,0.11595447648855511,0.45168706037953243,0.43430669694829854,0.1140062426721691,1,0,2,2,2,0,1
348,281,361,-67,13,0.4088368448901281,0.47838305388810826,0.11278010122176352,0.38406552625609763,0.46885486709072755,0.14707960665317477,1,1,1,3,4,0,0
357,273,300,-84,-57,0.432756949672565,0.4490564115163414,0.11818663881109351,0.4017099605738482,0.47004933287140743,0.12824070655474432,1,0,3,3,3,1,0
317,278,308,-39,-9,0.42092376310838414,0.4649600064729921,0.1141162304186237,0.4102204531355739,0.4778100940359813,0.11196945282844471,0,1,1,4,1,1,0
401,474,490,73,89,0.4529174049065003,0.43710091898047276,0.10998167611302681,0.3564489910098455,0.5135512663667195,0.12999974262343506,1,0,1,4,2,0,1
283,147,205,-136,-78,0.4186717709536853,0.47078914445409065,0.11053908459222428,0.42068370017288487,0.4654818117580421,0.11383448806907309,0,0,2,1,0,1,0
288,230,251,-58,-37,0.4512973379998046,0.4335869165096435,0.11511574549055188,0.4523947501531182,0.4272634561614366,0.1203417936854452,1,0,1,1,2,1,0
261,202,248,-59,-13,0.493734329027627,0.38515695298336655,0.1211087179890062,0.4216657792858306,0.4678534744616579,0.11048074625251149,0,1,1,1,1,1,0
290,233,269,-57,-21,0.4591193878034226,0.4255010711207169,0.11537954107586061,0.39241508073345177,0.48262449131386537,0.12496042795268276,0,1,1,2,1,1,0
381,290,355,-91,-26,0.5434597353229631,0.33569925348991153,0.12084101118712522,0.42269563460787163,0.4483753793885403,0.1289289860035881,0,1,1,1,1,1,0
295,311,333,16,38,0.4920927234055717,0.39241912117369593,0.11548815542073236,0.40493386075906207,0.45717339763038195,0.13789274161055604,1,0,1,1,2,0,1
236,149,219,-87,-17,0.5490962635256216,0.3348556087829519,0.11604812769142672,0.46870886321497,0.3882097693442551,0.14308136744077482,0,1,2,1,1,1,0
281,244,265,-37,-16,0.427288486744016,0.4589744734675963,0.11373703978838753,0.39314741763644995,0.47842753899675,0.12842504336679977,1,0,2,2,2,1,0
357,287,338,-70,-19,0.4424607688581633,0.44281532443638516,0.11472390670545174,0.4340541808662582,0.43343378981544733,0.1325120293182944,1,0,2,1,2,1,0
405,352,388,-53,-17,0.5072060792742848,0.37299194204488023,0.11980197868083509,0.5338109093878931,0.3576449833667734,0.10854410724533338,0,1,1,1,1,1,0
260,224,243,-36,-17,0.40572577832066575,0.4806326156241209,0.11364160605521316,0.4516096181504181,0.4323404894863332,0.11604989236324852,1,1,2,2,4,1,0
325,344,417,19,92,0.43336418324431614,0.4498799261449136,0.11675589061077045,0.35631710095043856,0.5271777661722704,0.11650513287729064,1,0,3,1,2,0,1
268,241,255,-27,-13,0.4646027807746663,0.41697223122194366,0.11842498800339012,0.39657467072678354,0.47665770661380086,0.12676762265941593,1,1,3,3,4,1,0
379,192,275,-187,-104,0.46758041822140184,0.41915479624704627,0.11326478553155198,0.462342434904475,0.43522166322440625,0.10243590187111865,0,0,2,1,0,1,0
332,81,174,-251,-158,0.46235432009789473,0.42106252738227656,0.1165831525198286,0.4949525078863597,0.3915016741127771,0.11354581800086318,1,0,1,1,2,1,0
317,345,357,28,40,0.4105476069317665,0.477737705104353,0.11171468796388073,0.48618992542863565,0.3831808084443057,0.13062926612705833,0,1,4,3,1,0,1
366,113,417,-253,51,0.49770589230505036,0.39150163520476056,0.11079247249018892,0.45043470816260367,0.4455219972691479,0.1040432945682486,1,0,1,1,2,0,0
516,279,332,-237,-184,0.4497135478241531,0.4365763664521412,0.11371008572370556,0.3167659389826906,0.561060950052446,0.12217311096486329,1,1,1,1,4,1,0
454,474,517,20,63,0.5285088703762781,0.353668334512152,0.11782279511156955,0.38906559679450947,0.4767355543045693,0.1341988489009212,1,0,1,2,2,0,1
265,160,283,-105,18,0.4674752034748738,0.4187033392424109,0.11382145728271537,0.4210090179055024,0.42722663916831616,0.15176434292618152,1,0,1,2,2,0,0
310,184,241,-126,-69,0.46652890489958976,0.419779568230744,0.11369152686966606,0.5244322679977678,0.36689069606474617,0.10867703593748598,1,0,1,1,3,1,0
364,397,464,33,100,0.4727041721125526,0.4095920785776007,0.11770374930984678,0.3079976006850549,0.5801783873848714,0.11182401193007387,1,0,2,1,2,0,1
363,329,382,-34,19,0.4557090108059614,0.42975916284439425,0.11453182634964429,0.3210887242329519,0.5671179931865619,0.11179328258048618,1,1,1,4,4,0,0
320,300,356,-20,36,0.4559090485284488,0.43117063217796026,0.1129203192935909,0.5020264110450303,0.39728363035132314,0.10068995860364657,1,0,1,3,2,0,0
216,156,187,-60,-29,0.4432192551027473,0.44498320888828424,0.11179753600896838,0.47729807181221307,0.415927388731934,0.10677453945585294,1,0,1,2,2,1,0
400,340,351,-60,-49,0.4611976697375993,0.4255791047349917,0.11322322552740886,0.47476417766543755,0.4125980145230079,0.11263780781155458,0,1,2,1,1,1,0
296,269,286,-27,-10,0.40328348327909436,0.48352121559130345,0.11319530112960208,0.5513688987975216,0.34068080903298265,0.10795029216949581,1,1,1,3,4,1,0
314,344,358,30,44,0.4453379916177848,0.44120166304978475,0.11346034533243067,0.30882383809789227,0.5485246692805159,0.1426514926215919,1,1,1,3,4,0,1
296,184,262,-112,-34,0.4315852035656507,0.4572253626747344,0.11118943375961507,0.31256532514510366,0.5788587286664639,0.10857594618843255,0,1,2,1,1,1,0
574,330,390,-244,-184,0.4081818262695763,0.4787257471121183,0.11309242661830546,0.3534707149192012,0.5326231788932196,0.11390610618757901,1,1,1,2,4,1,0
239,57,124,-182,-115,0.3991299177744408,0.49100605004596015,0.10986403217959886,0.32994500486887246,0.5617984317151478,0.10825656341597989,0,1,1,1,1,1,0
281,249,263,-32,-18,0.4335647746068702,0.453604621173508,0.11283060421962195,0.4674680507321718,0.42679822328978795,0.10573372597804047,1,0,3,3,2,1,0
317,213,304,-104,-13,0.44762242075535946,0.4386596433821753,0.11371793586246552,0.440687504848532,0.4354720248243157,0.1238404703271527,1,1,3,1,4,1,0
294,207,253,-87,-41,0.4533076030002888,0.43265285635401557,0.11403954064569537,0.44479182684697594,0.4340747880393952,0.12113338511362863,0,1,3,1,1,1,0
339,303,319,-36,-20,0.4231619416176245,0.4695739956573794,0.10726406272499572,0.49328263247015675,0.4108594089642417,0.09585795856560142,1,1,2,4,4,1,0
292,235,261,-57,-31,0.4037373582102941,0.4816765543465971,0.11458608744310884,0.5162469965674095,0.37471254236204704,0.10904046107054362,0,1,4,2,1,1,0
543,453,471,-90,-72,0.4813958729386691,0.40047046649932216,0.1181336605620085,0.42794870848828237,0.4642689200491306,0.10778237146258708,0,0,2,4,0,1,0
310,168,239,-142,-71,0.514322406500598,0.36670357098752704,0.11897402251187511,0.38777863208641417,0.4959023698450818,0.11631899806850385,1,0,3,1,2,1,0
422,375,409,-47,-13,0.3627045724680452,0.5245436387442431,0.11275178878771164,0.39083200696948134,0.48647670071402765,0.12269129231649105,1,1,3,1,4,1,0
328,251,286,-77,-42,0.447327275261734,0.4433657511190843,0.10930697361918178,0.4637669631473465,0.42688657259811164,0.1093464642545419,1,1,4,1,4,1,0
303,271,285,-32,-18,0.42742585470693484,0.46257376644509063,0.11000037884797444,0.4212525683525656,0.47338196514125924,0.10536546650617513,0,0,1,2,0,1,0
261,277,315,16,54,0.4530583456700545,0.4322026441708111,0.11473901015913479,0.43280824296688075,0.45662603347509245,0.11056572355802696,1,0,2,2,2,0,1
329,201,264,-128,-65,0.5003952908134456,0.3821773735628017,0.11742733562375281,0.33247462046552634,0.520981465950289,0.1465439135841842,0,0,1,1,0,1,0
388,341,357,-47,-31,0.5340529344952025,0.34952810224008724,0.11641896326471039,0.4527601530322745,0.44892879178060563,0.09831105518711973,1,0,1,3,2,1,0
253,169,221,-84,-32,0.44404026793758905,0.4443087047845802,0.1116510272778308,0.4838039451722884,0.40572349122308743,0.11047256360462436,0,1,2,1,1,1,0
370,233,282,-137,-88,0.5004633596417674,0.38311856443744413,0.11641807592078843,0.42165231849274154,0.4663911000577842,0.11195658144947442,0,0,1,1,0,1,0
230,174,194,-56,-36,0.4659956609127345,0.42173578437219167,0.11226855471507392,0.42699317393505193,0.46109108875319815,0.11191573731174978,1,0,2,2,2,1,0
474,536,593,62,119,0.4288881931827013,0.45507261371091956,0.11603919310637868,0.3184055038733245,0.5573779033858852,0.12421659274079017,0,0,1,4,0,0,1
529,437,502,-92,-27,0.4560256945487785,0.4313218786439179,0.11265242680730361,0.4514443625609147,0.44441324707085494,0.10414239036823061,1,0,1,1,2,1,0
296,206,240,-90,-56,0.441086837971454,0.44471901655759294,0.11419414547095301,0.4971006688677534,0.39702702230160636,0.10587230883063985,1,0,3,3,3,1,0
163,89,140,-74,-23,0.47851392518633734,0.4086901562209322,0.11279591859273053,0.4361200448286529,0.45637842484762065,0.10750153032372646,0,1,1,1,1,1,0
480,342,371,-138,-109,0.4439158925985413,0.438815057745086,0.11726904965637246,0.38196050247688995,0.4878228473441638,0.13021665017894596,1,0,1,3,2,1,0
323,336,378,13,55,0.4447960869387069,0.44200887108444425,0.11319504197684871,0.5046185379764574,0.38497618019578195,0.1104052818277609,1,0,1,1,2,0,1
264,222,247,-42,-17,0.44407757811577864,0.44120806082290537,0.114714361061316,0.45990548429485095,0.4305226982706341,0.10957181743451477,1,1,1,4,4,1,0
211,164,192,-47,-19,0.4144735850405918,0.469020480318565,0.11650593464084294,0.43018134600824814,0.4530282624493335,0.1167903915424182,1,1,1,2,4,1,0
281,24,78,-257,-203,0.45429835302423854,0.4327412951732446,0.1129603518025168,0.35677234769546945,0.52299200446573,0.12023564783880057,0,1,1,1,1,1,0
382,244,292,-138,-90,0.37473639482205506,0.5116605537868154,0.11360305139112933,0.32076015313826156,0.5727410586883225,0.10649878817341628,1,1,1,2,4,1,0
298,151,278,-147,-20,0.47382342719260795,0.4123663940983658,0.1138101787090262,0.5209947455702731,0.3828023713791562,0.09620288305057063,0,1,1,1,1,1,0
252,206,242,-46,-10,0.5151473373588451,0.36999797636318654,0.11485468627796822,0.3847768617253681,0.4791458670964189,0.13607727117821264,1,0,3,4,2,1,0
461,286,392,-175,-69,0.44552810038182666,0.4411243976834661,0.11334750193470715,0.30033281929084693,0.5907269692762934,0.10894021143285947,1,0,1,1,3,1,0
690,523,655,-167,-35,0.45486778995500465,0.4347538081724777,0.11037840187251792,0.28173934373255755,0.5641731646449638,0.154087491622479,1,0,1,1,2,1,0
459,367,410,-92,-49,0.42419923819070615,0.4629575401436189,0.11284322166567513,0.36187945976105246,0.5268345023736375,0.11128603786531004,1,0,1,1,2,1,0
296,228,330,-68,34,0.42378489344833636,0.4609384703081425,0.11527663624352126,0.4370659630833826,0.46321823543980395,0.09971580147681329,0,0,1,2,0,0,0
114,0,73,-114,-41,0.4542390078148661,0.4340906907250264,0.11167030146010762,0.4742882872260368,0.40877745252894454,0.11693426024501875,0,0,1,2,0,1,0
254,172,202,-82,-52,0.4523034279011375,0.43632263623245204,0.11137393586641048,0.4937254596377965,0.39658001986354996,0.10969452049865348,1,0,2,1,3,1,0
387,315,371,-72,-16,0.46457799816612777,0.42419493769427424,0.11122706413959813,0.32234306502772153,0.5411938538220498,0.13646308115022868,1,0,4,3,2,1,0
256,268,307,12,51,0.4447960869387069,0.44200887108444425,0.11319504197684871,0.5046185379764574,0.38497618019578195,0.1104052818277609,1,0,1,1,2,0,1
415,307,343,-108,-72,0.34557611299951296,0.5406666329157516,0.11375725408473553,0.437375073227208,0.44752507998345875,0.1150998467893334,1,1,1,4,4,1,0
203,217,305,14,102,0.4487043339464757,0.4372726397778854,0.11402302627563883,0.5008199010037189,0.3831711812469263,0.11600891774935473,0,0,2,1,0,0,1
463,277,310,-186,-153,0.4429214477246076,0.44829413069519514,0.10878442158019701,0.44916163467224096,0.4186075975511908,0.1322307677765681,0,1,2,2,1,1,0
409,297,356,-112,-53,0.5105236830255279,0.37405138639100544,0.11542493058346659,0.3924664597036931,0.46796988861357985,0.1395636516827271,0,0,1,2,0,1,0
405,255,375,-150,-30,0.5085981585889772,0.37633682428908005,0.11506501712194286,0.46147279832211346,0.40294627892634194,0.13558092275154446,0,1,2,1,1,1,0
339,241,305,-98,-34,0.3763783852557672,0.5065818909741019,0.1170397237701309,0.40320562965882123,0.47559757101956496,0.12119679932161387,1,1,3,1,4,1,0
162,22,95,-140,-67,0.4447960869387069,0.44200887108444425,0.11319504197684871,0.5046185379764574,0.38497618019578195,0.1104052818277609,0,1,1,1,1,1,0
371,428,498,57,127,0.44682320142802573,0.4399094429673614,0.11326735560461287,0.4157284624522321,0.4823209366760459,0.10195060087172188,1,0,1,3,2,0,1
362,312,405,-50,43,0.47426314166195027,0.4122854780273402,0.11345138031070923,0.441195914012762,0.4309560437639272,0.12784804222331092,0,0,1,1,0,0,0
490,433,468,-57,-22,0.49455444050064695,0.38634442652191664,0.1191011329774364,0.35047030335037305,0.5349659220292448,0.11456377462038227,1,1,1,2,4,1,0
308,234,297,-74,-11,0.4178460760829432,0.47121299040343795,0.11094093351361864,0.5115899424678092,0.3828625872214988,0.10554747031069212,1,0,3,2,3,1,0
478,270,398,-208,-80,0.45369124314355747,0.43118557966855986,0.11512317718788276,0.4266819627855259,0.4257807396904886,0.1475372975239855,1,1,1,2,4,1,0
263,171,211,-92,-52,0.4387911911640514,0.4485381942645711,0.11267061457137743,0.4245136212981692,0.4632929275014888,0.11219345120034181,0,0,3,1,0,1,0
339,186,371,-153,32,0.3645451851630361,0.5216706738191413,0.113784141017823,0.32950342770022983,0.5487651743162966,0.12173139798347339,0,1,2,1,1,0,0
562,453,549,-109,-13,0.4811951839108363,0.39823519423643905,0.12056962185272455,0.2600552593686953,0.6150822350911161,0.12486250554018827,1,0,2,1,2,1,0
479,378,414,-101,-65,0.42878834988251946,0.45953627206726066,0.11167537805021974,0.4377839026195779,0.42828092638049164,0.13393517099993035,1,1,2,4,4,1,0
355,411,428,56,73,0.4504698724703716,0.4338323371566444,0.11569779037298344,0.4911367774636377,0.38766440633290195,0.1211988162034604,0,0,1,3,0,0,1
351,192,280,-159,-71,0.45792387886693264,0.42876472107151287,0.11331140006155462,0.4562333872484235,0.4512996179531839,0.09246699479839249,0,0,1,1,0,1,0
337,181,224,-156,-113,0.5204032749352218,0.36350180119564646,0.11609492386913153,0.5056564165481655,0.3876504609401093,0.10669312251172496,1,0,1,2,2,1,0
256,17,105,-239,-151,0.4312838249715231,0.4601924668977784,0.10852370813069874,0.49000186121238426,0.4033309699623413,0.10666716882527477,1,1,1,1,4,1,0
454,380,469,-74,15,0.4945808464839101,0.3896590143182472,0.11576013919784275,0.4187984603958079,0.4748772663869817,0.10632427321721044,1,0,1,1,2,0,0
456,379,417,-77,-39,0.46750434202621755,0.4134379559708428,0.11905770200293939,0.4950158446551633,0.38368602057243323,0.1212981347724034,1,1,1,2,4,1,0
360,198,501,-162,141,0.44987442571007374,0.43931169329571773,0.11081388099420843,0.4661490861343761,0.411718665518946,0.12213224834667813,1,0,3,1,2,0,0
448,376,401,-72,-47,0.4649926483182749,0.42178480272927565,0.11322254895244922,0.4152998775705209,0.4741149628259839,0.11058515960349491,1,0,1,4,2,1,0
265,203,230,-62,-35,0.4658404853614685,0.42086187147486925,0.1132976431636622,0.40902340438866297,0.4772202099160482,0.11375638569528884,1,0,2,1,2,1,0
321,220,244,-101,-77,0.489939729693002,0.3927709832262313,0.11728928708076654,0.5700433969116292,0.3369826552888643,0.0929739477995065,0,1,3,2,1,1,0
299,215,248,-84,-51,0.45225032753836664,0.4342721049662129,0.11347756749542032,0.41745289442718847,0.478417428471084,0.10412967710172762,0,0,1,3,0,1,0
168,190,245,22,77,0.45379715956119004,0.43059857103571303,0.11560426940309693,0.37280345822311517,0.5018684623613783,0.12532807941550653,1,0,1,1,2,0,1
287,206,262,-81,-25,0.5120438007881125,0.3698184478430196,0.11813775136886785,0.355276004726832,0.5287007240498721,0.11602327122329587,0,0,3,1,0,1,0
372,277,332,-95,-40,0.41091464168985276,0.47608286692114377,0.11300249138900384,0.4146499923754038,0.4786054785682251,0.10674452905637102,1,0,4,1,2,1,0
545,468,501,-77,-44,0.41394245620448483,0.47235457893285077,0.11370296486266449,0.4233053956915634,0.4674668480391439,0.10922775626929258,1,0,1,3,2,1,0
290,231,266,-59,-24,0.47346886982343545,0.41585871471578595,0.11067241546077888,0.3142050851634593,0.5780012651328356,0.10779364970370521,1,1,3,1,4,1,0
298,249,287,-49,-11,0.38727159442057574,0.5003043706918926,0.11242403488753161,0.32919830173849035,0.5076469599960781,0.16315473826543148,0,0,1,2,0,1,0
385,318,350,-67,-35,0.4750954834846966,0.40792036345944116,0.11698415305586202,0.39689980226223137,0.48041691957435234,0.12268327816341641,1,0,2,5,2,1,0
292,210,271,-82,-21,0.47509057212284145,0.4109646598175868,0.11394476805957214,0.3949677761825228,0.49772639760949955,0.10730582620797768,1,0,1,3,2,1,0
234,245,252,11,18,0.47098892114168156,0.4187684918352898,0.11024258702302876,0.28222015090149266,0.5946568108500014,0.12312303824850593,1,0,1,2,2,0,1
371,347,391,-24,20,0.5302793723412718,0.35658876208244655,0.11313186557628174,0.4396814116362739,0.4407111238695269,0.11960746449419926,1,1,1,3,4,0,0
398,406,437,8,39,0.509290417124022,0.37054129177699774,0.12016829109898022,0.40061291706362073,0.443701708535758,0.1556853744006209,0,0,1,1,0,0,1
318,215,259,-103,-59,0.4485834932192135,0.4403575917910538,0.11105891498973271,0.41711251492022283,0.45487767870398155,0.12800980637579554,1,0,3,4,2,1,0
309,216,276,-93,-33,0.42087577929725106,0.46530623102175167,0.11381798968099738,0.4179717678494442,0.459426385224539,0.12260184692601692,1,1,3,1,4,1,0
321,203,278,-118,-43,0.47042447056853454,0.4134964178275113,0.11607911160395427,0.3855094216398394,0.4955444052680031,0.11894617309215741,1,1,2,3,4,1,0
467,0,16,-467,-451,0.4168310780216792,0.46974117265719045,0.11342774932113059,0.4257426000680307,0.437695174405783,0.13656222552618597,0,0,1,1,0,1,0
319,238,257,-81,-62,0.427867828070284,0.45741028255356847,0.11472188937614741,0.2550046319129447,0.6340276220182554,0.1109677460687998,0,0,2,2,0,1,0
308,240,287,-68,-21,0.4171449350891105,0.4732921210468019,0.10956294386408785,0.40191471893084046,0.49211085191361237,0.10597442915554708,1,0,3,2,3,1,0
274,245,311,-29,37,0.4176741662975231,0.46438631025430327,0.11793952344817361,0.33485757509694786,0.5333701005773536,0.13177232432569833,1,0,1,2,2,0,0
359,275,302,-84,-57,0.45145710816642143,0.43325538387369683,0.115287507959882,0.42097432675305396,0.4440879626558615,0.13493771059108434,0,1,2,1,1,1,0
315,210,234,-105,-81,0.4392697869371622,0.44115743583856887,0.11957277722426891,0.3958034676735633,0.49070614167777554,0.11349039064866114,0,0,1,2,0,1,0
448,284,430,-164,-18,0.5633250307500179,0.3265622677656348,0.11011270148434733,0.6458529417349612,0.23766836275671174,0.11647869550832717,0,1,1,1,1,1,0
288,204,276,-84,-12,0.44404680943918523,0.44325158138291676,0.11270160917789801,0.444770848203347,0.4248672569929172,0.13036189480373575,0,0,1,2,0,1,0
249,202,349,-47,100,0.4776869997941146,0.40636777888631337,0.11594522131957213,0.4803354252630552,0.40059195205522746,0.11907262268171702,0,0,4,1,0,0,0
364,170,261,-194,-103,0.41323349877770116,0.47317932701723014,0.11358717420506884,0.42677127700801787,0.45428352691172325,0.11894519608025886,1,0,1,1,3,1,0
384,262,353,-122,-31,0.4130609135955916,0.4731184462554924,0.11382064014891607,0.4764423264856523,0.42244145540065764,0.10111621811368988,1,1,1,1,4,1,0
536,551,618,15,82,0.455201987630263,0.43484367619956016,0.10995433617017708,0.283394184893885,0.5876484714315283,0.12895734367458675,1,0,5,1,2,0,1
212,188,199,-24,-13,0.490521949727807,0.39264010527621757,0.1168379449959754,0.42995294874458506,0.47519984298383444,0.09484720827158033,0,0,2,3,0,1,0
631,520,618,-111,-13,0.45112767791573927,0.43667937795050876,0.11219294413375192,0.47485035188949154,0.41451885587162657,0.11063079223888198,1,0,4,2,2,1,0
254,66,166,-188,-88,0.4357774031311239,0.45133285909389725,0.11288973777497857,0.5179327383572737,0.3766213182557748,0.10544594338695147,0,1,1,1,1,1,0
195,31,78,-164,-117,0.45415555526081425,0.4390634109512562,0.10678103378792958,0.42725058615015127,0.43785941115254634,0.13489000269730225,0,1,1,1,1,1,0
370,262,352,-108,-18,0.4314573020755074,0.4570620283125846,0.11148066961190795,0.5191752993599386,0.3632967479405455,0.11752795269951596,1,1,2,1,4,1,0
367,497,601,130,234,0.4929483758427664,0.3940969023805514,0.11295472177668238,0.43581511620661273,0.4471885448451965,0.11699633894819053,1,0,3,1,2,0,1
304,260,283,-44,-21,0.4536819211275429,0.4306482575338457,0.11566982133861131,0.39637008140436164,0.49067128998248544,0.11295862861315287,0,1,2,2,1,1,0
355,272,328,-83,-27,0.45543099205339804,0.4301362874304951,0.11443272051610705,0.5043519952554291,0.3843874962492973,0.11126050849527379,0,0,1,1,0,1,0
368,323,355,-45,-13,0.4425294713465054,0.4484131517362618,0.10905737691723293,0.44439780199717255,0.4287987015776086,0.12680349642521885,0,0,4,2,0,1,0
359,268,288,-91,-71,0.448787794254696,0.4379817069203462,0.11323049882495775,0.3572372359008583,0.5098058807467774,0.13295688335236439,1,0,1,1,3,1,0
263,168,236,-95,-27,0.47228287269127317,0.41148287467192374,0.11623425263680306,0.4803204218893504,0.3986515355943429,0.12102804251630646,0,0,1,2,0,1,0
374,406,421,32,47,0.43842283573714186,0.4503430428132821,0.1112341214495761,0.46403046397082637,0.39187370723195564,0.1440958287972178,1,0,3,1,2,0,1
285,150,164,-135,-121,0.4321673674379018,0.4555714347771443,0.11226119778495379,0.41532034535552576,0.4644479961668294,0.12023165847764487,1,1,1,1,4,1,0
367,307,393,-60,26,0.5034692779098261,0.3819257483535831,0.11460497373659062,0.454673333118372,0.4374453028730377,0.1078813640085902,1,1,1,2,4,0,0
346,241,306,-105,-40,0.43803039836464774,0.44874761265923824,0.1132219889761138,0.41851117325545223,0.46727712311672204,0.11421170362782548,1,0,1,1,2,1,0
448,240,311,-208,-137,0.4871124813822868,0.393909587482609,0.11897793113510406,0.3332814417360048,0.5522341139422924,0.11448444432170296,0,1,1,1,1,1,0
276,205,327,-71,51,0.46709227684437926,0.42255129717354434,0.11035642598207618,0.3749516715178519,0.4815192860113612,0.14352904247078674,1,0,1,3,2,0,0
360,337,348,-23,-12,0.4269702020252228,0.45317490800527543,0.11985488996950187,0.45134127107985605,0.441835019027856,0.10682370989228775,1,0,2,3,3,1,0
330,184,282,-146,-48,0.4447960869387069,0.44200887108444425,0.11319504197684871,0.5046185379764574,0.38497618019578195,0.1104052818277609,1,0,1,1,2,1,0
321,458,480,137,159,0.42963257022741796,0.4577885978918157,0.11257883188076648,0.4089330594094033,0.46059421674500656,0.13047272384559017,1,0,1,4,3,0,1
352,263,294,-89,-58,0.3802016174947793,0.5098946302110965,0.10990375229412416,0.39285725559658985,0.46280949141025407,0.14433325299315594,1,0,2,2,2,1,0
410,375,443,-35,33,0.45279969547808396,0.43273554406081166,0.11446476046110454,0.38420655315025376,0.49337023800986,0.12242320883988629,1,0,1,4,2,0,0
319,215,293,-104,-26,0.4373219510643147,0.4484944326349301,0.1141836163007552,0.32517495532278506,0.572261940671787,0.10256310400542784,1,1,2,5,4,1,0
280,312,400,32,120,0.41450938809355964,0.4709937969757266,0.11449681493071355,0.44813563509637483,0.43032644507695195,0.12153791982667357,1,0,2,1,2,0,1
344,243,259,-101,-85,0.39479917674418946,0.498146188517445,0.10705463473836556,0.4702661913023111,0.40728273063355863,0.1224510780641303,0,1,1,1,1,1,0
683,465,662,-218,-21,0.5407207887021438,0.339259016974004,0.12002019432385214,0.5031382394546983,0.3963887368671819,0.10047302367811976,1,1,1,1,4,1,0
313,232,300,-81,-13,0.4555303103712122,0.43232118291305616,0.11214850671573168,0.32676635698509066,0.5597398497755286,0.11349379323938057,1,0,2,1,2,1,0
374,259,288,-115,-86,0.49459957540737837,0.3943969048975076,0.11100351969511389,0.411960684606531,0.4663227343503937,0.12171658104307546,0,1,2,1,1,1,0
428,288,340,-140,-88,0.4636236092500253,0.42327637877911656,0.1131000119708582,0.4552914951225217,0.44420440397168903,0.10050410090578928,1,1,2,1,4,1,0
528,429,510,-99,-18,0.35410022590314155,0.5307126715710863,0.11518710252577193,0.36288172936629126,0.5236165310028441,0.1135017396308646,1,0,2,4,3,1,0
360,123,335,-237,-25,0.4811712235920624,0.4025299444430176,0.11629883196492029,0.5313100187435135,0.3547500895960082,0.11393989166047835,1,1,1,1,4,1,0
417,367,397,-50,-20,0.4160429417515821,0.47475245000813704,0.10920460824028115,0.49139803102050056,0.36261004455509566,0.1459919244244037,0,1,1,1,1,1,0
358,290,341,-68,-17,0.4614153159849542,0.43013611005207997,0.10844857396296573,0.49249406151081515,0.39465330078582234,0.11285263770336247,1,1,2,1,4,1,0
304,161,312,-143,8,0.43046990532108276,0.4585142864841391,0.11101580819477794,0.3945836980216846,0.48045016767967397,0.12496613429864159,1,0,2,1,2,0,0
403,322,388,-81,-15,0.45121678026372275,0.4318564604233759,0.1169267593129012,0.3341188911740492,0.49793181301640976,0.16794929580954085,0,0,2,1,0,1,0
316,261,296,-55,-20,0.44947398105679526,0.4362374850697278,0.11428853387347677,0.4643911719270145,0.42658246156750906,0.10902636650547651,1,1,2,1,4,1,0
238,185,286,-53,48,0.4509265860778718,0.43341520095457964,0.11565821296754826,0.41080657607853366,0.47619759863752525,0.11299582528394124,0,1,1,2,1,0,0
318,382,401,64,83,0.44324277101725235,0.44426013375777645,0.1124970952249711,0.3305209428177455,0.5505557865011256,0.1189232706811289,1,0,1,2,2,0,1
350,226,340,-124,-10,0.4274605930098188,0.46242981119513216,0.11010959579504903,0.4579356135128917,0.42420023127480166,0.1178641552123067,0,0,1,3,0,1,0
341,263,276,-78,-65,0.41949257706632104,0.46893249133305936,0.11157493160061978,0.4360284548231788,0.4515333614624175,0.11243818371440358,0,1,3,1,1,1,0
297,173,203,-124,-94,0.4707701781914278,0.41545641286008084,0.11377340894849153,0.4637304533199871,0.41873450061992745,0.11753504606008529,0,0,1,3,0,1,0
396,318,329,-78,-67,0.4546295650554529,0.42877228051181265,0.1165981544327344,0.4685712093575717,0.41048704245746165,0.12094174818496668,1,1,1,3,4,1,0
307,253,289,-54,-18,0.4249472237140531,0.4626285856491012,0.1124241906368456,0.40155450399293907,0.4782144220946877,0.12023107391237353,0,0,3,1,0,1,0
299,244,275,-55,-24,0.4587085307859193,0.4253138406748604,0.11597762853922028,0.41753540735978767,0.4875685129122466,0.09489607972796579,0,1,1,2,1,1,0
239,56,144,-183,-95,0.45210532291791733,0.4314354236677864,0.11645925341429615,0.44067953233374435,0.4420601447852297,0.1172603228810259,0,1,1,1,1,1,0
275,187,454,-88,179,0.3963543554175931,0.49266847044838663,0.11097717413402021,0.30644576993952477,0.564562340780285,0.12899188928019023,0,0,2,1,0,0,0
472,249,265,-223,-207,0.4598712157525374,0.4269933700913559,0.11313541415610676,0.4464187366059236,0.45789949814991104,0.09568176524416529,1,0,2,3,2,1,0
384,287,300,-97,-84,0.4186112361623431,0.4640140066551572,0.11737475718249965,0.41409388242547474,0.45808069138681307,0.12782542618771217,1,0,3,1,2,1,0
274,177,220,-97,-54,0.4305737485857331,0.4556936716214418,0.11373257979282476,0.34108950880155653,0.5476709644353899,0.11123952676305365,1,0,1,1,2,1,0
348,277,301,-71,-47,0.482211835330044,0.40227757951176385,0.11551058515819193,0.39836365854525035,0.4795866206798369,0.12204972077491298,0,0,1,2,0,1,0
294,248,270,-46,-24,0.4282057339723887,0.46072052385380574,0.11107374217380554,0.4214949763345308,0.45408184309181776,0.12442318057365158,1,0,2,1,2,1,0
231,91,100,-140,-131,0.4535302164750773,0.4345563611667486,0.11191342235817402,0.44254931709601986,0.4439724591084869,0.11347822379549337,0,1,1,2,1,1,0
410,349,402,-61,-8,0.41940460431616117,0.4701128579356935,0.1104825377481454,0.3325467345075744,0.558022010728756,0.10943125476366933,1,0,1,1,2,1,0
137,48,113,-89,-24,0.4468008974761879,0.4395198670616812,0.11367923546213109,0.4530103548569846,0.41201135195295185,0.13497829319006363,1,1,1,1,4,1,0
282,395,446,113,164,0.4522644895699141,0.4358682490908443,0.11186726133924176,0.5055626978721484,0.386491914961713,0.10794538716613866,0,0,1,3,0,0,1
209,158,186,-51,-23,0.44237326239783276,0.4440972691721915,0.11352946842997594,0.46110932864697474,0.42187008732660053,0.11702058402642457,1,0,1,2,3,1,0
306,184,289,-122,-17,0.4884763510596091,0.39886882291073966,0.11265482602965114,0.49269850808606763,0.4004368448402237,0.10686464707370871,0,0,1,1,0,1,0
399,303,518,-96,119,0.44148176472540235,0.4506942671334504,0.10782396814114727,0.41022520193257267,0.4665577318933246,0.12321706617410275,1,0,1,1,2,0,0
90,0,16,-90,-74,0.4266866588306916,0.4597464389118944,0.11356690225741403,0.4349011646003022,0.45327265200115957,0.11182618339853814,0,0,1,1,0,1,0
272,161,249,-111,-23,0.4447960869387069,0.44200887108444425,0.11319504197684871,0.5046185379764574,0.38497618019578195,0.1104052818277609,1,0,1,2,2,1,0
282,309,356,27,74,0.40627091155155826,0.4737943617139484,0.11993472673449349,0.38517802890713304,0.46968415122780055,0.14513781986506655,1,0,2,2,2,0,1
294,193,365,-101,71,0.5438259756151428,0.3419525763133745,0.11422144807148282,0.40369326535748573,0.4659848815409272,0.13032185310158692,1,1,5,1,4,0,0
357,276,319,-81,-38,0.47019594514973584,0.4175334351761907,0.1122706196740736,0.47721762139645424,0.4140266229760952,0.10875575562745049,0,0,1,2,0,1,0
338,275,291,-63,-47,0.45798046858514424,0.4228580378232233,0.11916149359163246,0.389932346653718,0.5003342941734867,0.10973335917279547,1,0,3,1,2,1,0
636,757,877,121,241,0.4447960869387069,0.44200887108444425,0.11319504197684871,0.5046185379764574,0.38497618019578195,0.1104052818277609,0,1,1,1,1,0,1
393,369,378,-24,-15,0.4596514403034398,0.42612424659284504,0.11422431310371507,0.4942254698138908,0.3873597927256061,0.11841473746050304,1,0,3,3,2,1,0
338,372,479,34,141,0.5060316787984175,0.38075605637946525,0.11321226482211717,0.3017754878740408,0.5532216226909001,0.1450028894350592,1,0,1,2,2,0,1
115,0,74,-115,-41,0.4447960869387069,0.44200887108444425,0.11319504197684871,0.5046185379764574,0.38497618019578195,0.1104052818277609,1,1,1,1,4,1,0
365,318,343,-47,-22,0.4644367449580066,0.4218946143457998,0.11366864069619362,0.42773164447589695,0.4710793078287942,0.10118904769530863,1,0,2,2,3,1,0
593,506,573,-87,-20,0.4447960869387069,0.44200887108444425,0.11319504197684871,0.5046185379764574,0.38497618019578195,0.1104052818277609,1,0,1,1,2,1,0
286,310,324,24,38,0.35895007699969467,0.527765063314599,0.11328485968570597,0.41964284404724256,0.4551077846818189,0.1252493712709385,0,0,1,1,0,0,1
81,47,65,-34,-16,0.4447960869387069,0.44200887108444425,0.11319504197684871,0.5046185379764574,0.38497618019578195,0.1104052818277609,1,0,1,1,2,1,0
342,286,318,-56,-24,0.4486244366677536,0.4401553654284695,0.11122019790377684,0.41162203471132114,0.47931787486828453,0.1090600904203945,1,0,1,2,2,1,0
239,195,219,-44,-20,0.5133623377785759,0.3725718859689041,0.11406577625251973,0.4800181050093021,0.40624604659922847,0.11373584839146968,0,0,3,2,0,1,0
354,285,317,-69,-37,0.4436150425531927,0.4420330427581208,0.1143519146886866,0.4487762322009175,0.43409129503153326,0.1171324727675493,0,0,1,4,0,1,0
685,570,613,-115,-72,0.4377284321570836,0.44898811515541565,0.1132834526875006,0.47791746681206493,0.4078520991891214,0.11423043399881345,1,0,1,1,2,1,0
245,200,232,-45,-13,0.444363000083309,0.4449863749722725,0.11065062494441819,0.45761249034143864,0.4370988371885045,0.10528867247005706,1,0,1,1,2,1,0
339,230,323,-109,-16,0.46683483981304164,0.4180098079374718,0.11515535224948613,0.4198514330147855,0.4521223537323074,0.12802621325290703,0,1,1,1,1,1,0
264,171,207,-93,-57,0.4563777556430501,0.4290825093417343,0.11453973501521549,0.4405559844825246,0.45247749598857673,0.10696651952889843,1,0,1,2,2,1,0
439,314,401,-125,-38,0.4068462787586834,0.4786449299271967,0.11450879131411996,0.43767985281310184,0.4465363294281788,0.1157838177587193,0,0,1,1,0,1,0
252,192,224,-60,-28,0.44058620186923564,0.44665989399011125,0.11275390414065309,0.46935503418997665,0.39566001574938825,0.13498495006063504,1,1,1,1,4,1,0
308,189,223,-119,-85,0.5684570889260914,0.3162495885515678,0.1152933225223404,0.5763904225675645,0.32628169923556566,0.09732787819686979,0,1,1,1,1,1,0
257,282,345,25,88,0.4777864131309934,0.40815236691661766,0.11406121995238912,0.5049414239159397,0.3698846091404308,0.12517396694362976,1,0,2,1,2,0,1
205,91,245,-114,40,0.47336310479232063,0.4114292676938386,0.11520762751384074,0.4097964226147175,0.4743934232900419,0.1158101540952403,1,0,2,1,2,0,0
469,350,478,-119,9,0.47434462408616657,0.4145553973036183,0.11109997861021531,0.3954259944406864,0.4712578304226012,0.13331617513671218,1,0,1,2,2,0,0
229,287,303,58,74,0.396973730485202,0.48884715672774237,0.1141791127870556,0.4349204413562906,0.45641426067831614,0.10866529796539315,1,1,1,2,4,0,1
287,203,222,-84,-65,0.46624575900711124,0.4203301426577577,0.1134240983351311,0.35082564653670795,0.527303835392966,0.12187051807032612,0,1,2,3,1,1,0
84,158,301,74,217,0.44241045215954766,0.4454242799557593,0.11216526788469301,0.47454759160096244,0.4202436452647284,0.10520876313430927,1,0,1,1,2,0,1
386,398,434,12,48,0.35937081306658747,0.5274196667587667,0.11320952017464553,0.5152120591104993,0.3597274764943111,0.1250604643951897,1,0,3,3,2,0,1
336,356,409,20,73,0.42044745286583113,0.4650055155543564,0.11454703157981248,0.41599407403698807,0.48537382283578,0.0986321031272319,1,0,2,2,3,0,1
341,296,324,-45,-17,0.44398862507617215,0.44173091155983363,0.11428046336399428,0.3927044003906527,0.4753073937897755,0.13198820581957166,1,1,1,2,4,1,0
394,352,378,-42,-16,0.4697318667720726,0.4110269907775148,0.11924114245041245,0.47649685184698864,0.41576998638457935,0.10773316176843192,1,0,1,1,2,1,0
376,156,251,-220,-125,0.44572107127863514,0.44430990325159064,0.10996902546977425,0.4535712057337946,0.43960914299953546,0.10681965126666974,1,1,1,2,4,1,0
255,156,226,-99,-29,0.429654138989017,0.4557921481304281,0.11455371288055498,0.49014957535641673,0.39307552423959796,0.11677490040398532,1,0,1,1,2,1,0
311,0,235,-311,-76,0.4447960869387069,0.44200887108444425,0.11319504197684871,0.5046185379764574,0.38497618019578195,0.1104052818277609,1,0,1,1,2,1,0
462,335,393,-127,-69,0.4047056360073596,0.4815876206716015,0.11370674332103896,0.4670050480097043,0.40143540389347837,0.13155954809681736,1,0,2,1,2,1,0
245,202,229,-43,-16,0.4260042663936217,0.4608275703664424,0.11316816323993609,0.44253474192359765,0.4568926679475172,0.10057259012888495,0,0,3,3,0,1,0
289,302,375,13,86,0.3815030834231486,0.5073715062530848,0.11112541032376681,0.3162221665379496,0.5732798560491417,0.11049797741290876,1,0,3,1,2,0,1
302,229,281,-73,-21,0.4652586627466725,0.41939194414500824,0.11534939310831921,0.5116567407907557,0.37491214316243376,0.11343111604681036,1,0,2,2,3,1,0
352,219,369,-133,17,0.4286028228527207,0.45753741573822054,0.11385976140905887,0.40515526520259765,0.46551105223308215,0.12933368256431998,0,0,2,1,0,0,0
411,245,283,-166,-128,0.5062889089852761,0.37110744823694375,0.12260364277778013,0.38147125937937565,0.48470664681026343,0.13382209381036086,0,1,1,1,1,1,0
314,177,255,-137,-59,0.4622525590623976,0.42563352347329486,0.11211391746430757,0.48396165154145615,0.40945538558838457,0.10658296287015924,1,0,4,1,2,1,0
413,250,312,-163,-101,0.4906808020302458,0.39405894272595837,0.11526025524379582,0.4532318679976592,0.44624186395408566,0.1005262680482552,1,1,1,2,4,1,0
329,170,298,-159,-31,0.4433076411378688,0.44236651524605414,0.11432584361607699,0.4705996078458564,0.41533262526272163,0.11406776689142217,0,0,1,2,0,1,0
337,300,312,-37,-25,0.43395485395602756,0.45257056968878984,0.11347457635518242,0.345720950400463,0.4787434887749428,0.17553556082459426,1,0,1,3,2,1,0
356,376,387,20,31,0.4081299467472366,0.47868167115180954,0.11318838210095385,0.4862396241209851,0.41075369380100324,0.10300668207801171,1,0,2,1,2,0,1
549,417,470,-132,-79,0.43725042832753147,0.4527467349026682,0.11000283676980031,0.23647523536473222,0.6463269351580054,0.11719782947726247,1,1,1,3,4,1,0
297,229,312,-68,15,0.46538054332475776,0.42313612656371247,0.11148333011152978,0.4503707564478563,0.41857330606934456,0.1310559374827993,1,0,2,2,2,0,0
169,179,244,10,75,0.3618824694705308,0.5247731610928458,0.1133443694366232,0.4683808368957122,0.41156604960840987,0.12005311349587788,1,1,2,1,4,0,1
236,159,172,-77,-64,0.46196897705812984,0.4239350515074997,0.11409597143437061,0.46984994046898115,0.41960919911867756,0.11054086041234135,1,1,2,1,4,1,0
336,257,332,-79,-4,0.48160069062530253,0.404522846601905,0.11387646277279245,0.4045083320129068,0.4875326856985959,0.1079589822884974,1,0,2,2,2,1,0
370,233,358,-137,-12,0.45579203398030765,0.43348602544516107,0.11072194057453133,0.38952371963583193,0.4852825426998141,0.12519373766435388,1,0,4,1,2,1,0
239,271,309,32,70,0.38794526020764203,0.5004653152148507,0.11158942457750705,0.41474130901719636,0.47698476381611293,0.10827392716669075,0,1,3,4,1,0,1
289,256,273,-33,-16,0.4114421348235202,0.47793370724944073,0.11062415792703909,0.4802297657290324,0.40065227368246387,0.1191179605885034,1,1,3,1,4,1,0
366,379,395,13,29,0.3844506640436248,0.50135329325258,0.11419604270379509,0.38300842823655906,0.515162524567525,0.10182904719591603,1,0,5,3,2,0,1
380,246,339,-134,-41,0.45592231305451625,0.4293344146191675,0.11474327232631638,0.41603896238552035,0.47428880386956623,0.10967223374491337,0,1,2,2,1,1,0
403,222,282,-181,-121,0.3938497267037766,0.4955287489024039,0.1106215243938195,0.475133018862001,0.41892610484954923,0.1059408762884498,0,0,1,1,0,1,0
365,228,309,-137,-56,0.4303188672036439,0.45414913547625707,0.11553199732009913,0.3528728941468015,0.5379749431562812,0.10915216269691702,0,0,1,1,0,1,0
554,502,562,-52,8,0.5093945003060667,0.3714027054476398,0.11920279424629344,0.23549033100928482,0.604977582572704,0.15953208641801117,1,0,1,2,2,0,0
339,223,301,-116,-38,0.45126479062974906,0.43472764894887833,0.11400756042137261,0.48853433904889276,0.4072608428499285,0.10420481810117875,0,1,2,1,1,1,0
318,272,294,-46,-24,0.4358805123525499,0.4524022268014659,0.11171726084598405,0.4333114284938973,0.44184252906874444,0.12484604243735792,0,0,1,3,0,1,0
420,388,394,-32,-26,0.4209308807577347,0.46713976903718174,0.11192935020508364,0.31025114459529357,0.5642369390872557,0.12551191631745115,1,1,1,1,4,1,0
327,184,236,-143,-91,0.44212742779644465,0.44582575142756764,0.11204682077598799,0.45666804043492815,0.4251206728571148,0.11821128670795712,1,0,2,1,2,1,0
265,181,279,-84,14,0.4714174563742968,0.4107149129755473,0.11786763065015594,0.4302562052099274,0.45758679018860415,0.11215700460146832,1,0,2,1,2,0,0
402,310,336,-92,-66,0.4511563562298823,0.43487198054145043,0.11397166322866722,0.3883962829806562,0.46963138040327007,0.14197233661607359,1,0,1,1,2,1,0
340,411,467,71,127,0.46843297525466726,0.4135075908982436,0.11805943384708881,0.33989073830837696,0.5258446552728553,0.13426460641876778,1,0,4,2,2,0,1
261,173,191,-88,-70,0.43280314875489656,0.4571877621733513,0.11000908907175252,0.4809372033771319,0.3781015458658645,0.14096125075700347,0,0,1,2,0,1,0
295,181,289,-114,-6,0.4149496774390169,0.47117658861222256,0.11387373394876085,0.4221547019523714,0.4638398482354881,0.11400544981214045,0,1,1,3,1,1,0
332,200,336,-132,4,0.44516841625781145,0.44187387423002344,0.11295770951216509,0.342874084371439,0.5177965379147225,0.13932937771383894,0,0,1,1,0,0,0
335,308,364,-27,29,0.45212458180204684,0.43283493198245315,0.11504048621550003,0.48896982707386355,0.39805135731227714,0.11297881561385936,1,0,1,3,2,0,0
401,334,352,-67,-49,0.43578736134519175,0.45098096490643685,0.11323167374837134,0.443751466577613,0.43052515154429494,0.12572338187809196,0,0,1,1,0,1,0
316,227,299,-89,-17,0.46143065734562755,0.43041380843341265,0.10815553422095987,0.513412521186329,0.3892348293072101,0.097352649506461,0,0,2,1,0,1,0
343,303,439,-40,96,0.4273525615776839,0.4629482402839564,0.1096991981383596,0.3832635121894596,0.4799053857920635,0.13683110201847687,0,1,1,2,1,0,0
459,333,373,-126,-86,0.4478785070027503,0.44521103717796284,0.10691045581928688,0.3400915126479091,0.5440176465931857,0.1158908407589048,0,0,1,3,0,1,0
614,633,684,19,70,0.4531241875227976,0.43897289586165866,0.10790291661554398,0.21404785605853904,0.6682452773237594,0.11770686661770156,1,0,1,4,2,0,1
231,163,203,-68,-28,0.4152755866209094,0.4685899270177004,0.11613448636139015,0.4483830829992281,0.43543922639289534,0.11617769060787644,0,0,2,1,0,1,0
267,178,239,-89,-28,0.34682038880983945,0.5367837665369862,0.1163958446531741,0.5183521131546809,0.37432029237956654,0.10732759446575256,0,1,1,1,1,1,0
308,262,270,-46,-38,0.45425587594782013,0.4321314804322407,0.11361264361993918,0.4173330701926889,0.46410500551568523,0.11856192429162589,1,1,2,1,4,1,0
322,283,415,-39,93,0.4381874547480318,0.44870871672724055,0.11310382852472742,0.5084979256172925,0.3390512241479497,0.15245085023475768,0,0,3,1,0,0,0
295,260,281,-35,-14,0.40940646376295475,0.47233305646039836,0.11826047977664679,0.44504473646465986,0.44344425799089504,0.11151100554444501,0,0,1,1,0,1,0
406,332,366,-74,-40,0.44846492712685443,0.43639161156815043,0.11514346130499524,0.39342592707212337,0.4706464335556058,0.13592763937227068,0,0,2,2,0,1,0
384,275,330,-109,-54,0.4575190255663047,0.43111253993878706,0.11136843449490853,0.47393080369338714,0.4106365862295838,0.11543261007702887,1,0,2,4,2,1,0
351,249,310,-102,-41,0.4715654011750094,0.4144797291346718,0.11395486969031852,0.4722495335135149,0.43229205341786175,0.09545841306862321,0,1,2,1,1,1,0
288,254,334,-34,46,0.48687064824966464,0.4019320895988647,0.11119726215147081,0.5932827034752265,0.2946359851548425,0.11208131136993088,1,1,1,1,4,0,0
397,378,413,-19,16,0.3769174305295967,0.5127901581178256,0.11029241135257745,0.3571496245043552,0.5392676931534279,0.1035826823422168,1,0,1,2,2,0,0
266,275,320,9,54,0.4428823753421635,0.44371858327437047,0.11339904138346608,0.5214722817191243,0.3748797520438045,0.10364796623707098,0,1,3,2,1,0,1
269,181,212,-88,-57,0.4432333940262292,0.4430473483061256,0.11371925766764518,0.4690595821465683,0.417768699501745,0.11317171835168677,1,1,1,3,4,1,0
291,247,269,-44,-22,0.45683825098740827,0.4311217644138405,0.11203998459875136,0.5104256425030343,0.38608568004808264,0.1034886774488829,0,0,2,3,0,1,0
282,216,259,-66,-23,0.45283716728000917,0.437084479824644,0.11007835289534687,0.35628932037984234,0.5364547357787377,0.10725594384142,1,0,2,2,2,1,0
340,276,309,-64,-31,0.4230608534067643,0.46591221671228555,0.1110269298809498,0.32348583042483686,0.5459400023626291,0.1305741672125339,1,0,1,3,3,1,0
376,240,263,-136,-113,0.46875317862269467,0.4183746442677406,0.1128721771095645,0.44476072462897365,0.436175998690666,0.11906327668036021,0,1,2,1,1,1,0
657,509,611,-148,-46,0.4375949436344829,0.44957913366648494,0.11282592269903224,0.2549043649010484,0.6217470150401608,0.12334862005879066,1,1,3,1,4,1,0
275,125,138,-150,-137,0.4929677307419998,0.3827201092463675,0.1243121600116331,0.4610227860155904,0.38149142369398537,0.15748579029042423,0,0,3,1,0,1,0
513,546,560,33,47,0.4641240664299577,0.4222784500193066,0.11359748355073569,0.31612989618697124,0.49906659851529206,0.18480350529773681,0,0,1,2,0,0,1
165,207,235,42,70,0.4744841273349023,0.40835468089721844,0.11716119176787938,0.42762186589146406,0.46227536143435144,0.11010277267418449,1,1,1,2,4,0,1
329,280,318,-49,-11,0.4421404869435174,0.44415086997839426,0.1137086430780882,0.47522092970865226,0.42654885707495194,0.09823021321639556,0,0,1,3,0,1,0
316,282,298,-34,-18,0.4550333112664363,0.43080952471074235,0.11415716402282147,0.38544155080003384,0.49621658700262605,0.11834186219734,1,1,3,3,4,1,0
316,266,280,-50,-36,0.4716237612735014,0.4127791385785542,0.11559710014794439,0.3696172096517213,0.5131117249108998,0.1172710654373785,0,1,3,4,1,1,0
449,268,374,-181,-75,0.4826899595118862,0.40145113266084964,0.11585890782726409,0.43864988585751363,0.43219072251319074,0.12915939162929563,0,1,1,1,1,1,0
382,343,358,-39,-24,0.43862762430422153,0.45298415092193667,0.10838822477384166,0.3730245653983666,0.5040989738627227,0.12287646073891091,1,1,4,3,4,1,0
370,360,403,-10,33,0.4252157284036866,0.46316881287990375,0.11161545871640967,0.3602115497183111,0.48974626944255917,0.15004218083912968,0,1,4,5,1,0,0
256,159,292,-97,36,0.43441778378624096,0.4528156286152434,0.11276658759851553,0.5081418112496846,0.38413390216090304,0.10772428658941223,0,0,1,1,0,0,0
399,167,378,-232,-21,0.42990307463472416,0.45814108209976206,0.1119558432655139,0.4864619309558886,0.41073423583327745,0.10280383321083414,1,0,1,1,2,1,0
310,214,340,-96,30,0.43551371094311286,0.4557515790302428,0.10873471002664424,0.3701532962259666,0.5212980061843306,0.108548697589703,1,0,1,4,2,0,0
342,209,327,-133,-15,0.45579564443427206,0.42875049985019825,0.11545385571552978,0.4318186348416987,0.454581828460933,0.1135995366973684,0,0,1,1,0,1,0
272,316,333,44,61,0.4790903054093039,0.4050930884783591,0.1158166061123371,0.47042911238455326,0.437151365626367,0.09241952198907956,1,0,1,1,2,0,1
326,209,246,-117,-80,0.5029301937163065,0.3823709723800529,0.11469883390364081,0.4846837027571679,0.4105169520156568,0.10479934522717525,0,1,1,1,1,1,0
494,368,445,-126,-49,0.5047266173564822,0.3828350162278963,0.11243836641562166,0.3561042058486734,0.5236068011015126,0.12028899304981414,1,0,2,1,2,1,0
325,133,227,-192,-98,0.4520358205288874,0.43524941336056727,0.11271476611054529,0.48178621941176825,0.40286502741999364,0.1153487531682379,0,0,2,1,0,1,0
428,396,448,-32,20,0.48982599932078286,0.38881286481939176,0.12136113585982557,0.27303967951555724,0.6060085781160987,0.12095174236834402,1,0,1,2,2,0,0
327,217,228,-110,-99,0.45265144984234285,0.4334733812335388,0.11387516892411814,0.5190245796954277,0.36754493548139927,0.11343048482317293,1,0,3,2,2,1,0
275,154,191,-121,-84,0.4433747380336726,0.4456900341057788,0.11093522786054859,0.503359135097608,0.3808567850239144,0.11578407987847764,0,1,1,1,1,1,0
474,247,397,-227,-77,0.47528791323874575,0.41172676881534004,0.11298531794591445,0.5247707817227212,0.353079566020495,0.1221496522567841,1,1,2,1,4,1,0
262,157,363,-105,101,0.4727240543275394,0.41592549404110324,0.11135045163135747,0.4967264810685753,0.3967453277739814,0.10652819115744316,1,0,3,1,2,0,0
295,201,274,-94,-21,0.41888557128289455,0.4702148092265508,0.11089961949055475,0.37239282435802784,0.5150787505136535,0.11252842512831872,0,0,2,1,0,1,0
319,178,230,-141,-89,0.4355128113643697,0.4508743274291164,0.11361286120651412,0.3193542648263979,0.5675648516458043,0.11308088352779765,1,0,1,1,2,1,0
349,418,468,69,119,0.4447960869387069,0.44200887108444425,0.11319504197684871,0.5046185379764574,0.38497618019578195,0.1104052818277609,1,0,1,1,2,0,1
330,295,318,-35,-12,0.4730141700744306,0.41124804164460665,0.11573778828096294,0.5188852217643272,0.3847304405277767,0.09638433770789613,0,1,2,2,1,1,0
246,181,222,-65,-24,0.39941487805559206,0.4861416086735578,0.11444351327084992,0.3883257827638063,0.4872157783994186,0.12445843883677499,1,1,3,3,4,1,0
281,234,271,-47,-10,0.4359868432184683,0.4512575787805468,0.11275557800098489,0.4294541511086393,0.4516280537210614,0.11891779517029911,1,1,1,2,4,1,0
275,226,240,-49,-35,0.42168643127483674,0.4657976970645649,0.11251587166059825,0.32489335255875457,0.5412469303434191,0.13385971709782674,0,1,3,3,1,1,0
362,237,325,-125,-37,0.454653151295017,0.43531874157392325,0.11002810713105945,0.4676410249056369,0.40118034687930143,0.13117862821506196,1,1,1,2,4,1,0
302,96,226,-206,-76,0.4702281792532908,0.4205334639551646,0.10923835679154476,0.40465592206717044,0.4923399885590905,0.10300408937373902,0,1,1,1,1,1,0
261,108,119,-153,-142,0.4529961873743329,0.4333807189533135,0.11362309367235354,0.47434534548041135,0.4142957286565554,0.11135892586303336,1,1,1,1,4,1,0
434,378,424,-56,-10,0.5450904277714074,0.3393188821691687,0.11559069005942393,0.44641527414685905,0.4315820129958945,0.12200271285724607,0,1,1,2,1,1,0
425,311,383,-114,-42,0.3905671400766445,0.5006850522960518,0.10874780762730375,0.30359405703485326,0.5770241684132514,0.11938177455189519,1,1,2,1,4,1,0
393,227,332,-166,-61,0.4572051165490081,0.4251601796499053,0.11763470380108672,0.5094015847120827,0.39599178380227545,0.09460663148564144,1,1,1,1,4,1,0
339,287,294,-52,-45,0.43770112676528894,0.44706432751994596,0.11523454571476492,0.4228461009711201,0.4646897472720477,0.11246415175683246,0,0,2,1,0,1,0
280,180,266,-100,-14,0.47464576771615763,0.41382026050041626,0.11153397178342599,0.3766803746559351,0.5049772983516169,0.118342326992448,1,0,2,1,2,1,0
320,364,402,44,82,0.4285398978890457,0.4551102378596758,0.11634986425127826,0.40361318822432596,0.45888672954957616,0.1375000822260977,1,0,5,1,2,0,1
507,468,492,-39,-15,0.5080855069521978,0.3774487790604581,0.11446571398734429,0.4051276989037066,0.4927942897271945,0.10207801136909865,1,1,2,3,4,1,0
461,352,365,-109,-96,0.3819819963918185,0.5039520405886913,0.11406596301948992,0.40708379007157064,0.461476966740442,0.13143924318798728,1,0,1,3,3,1,0
157,131,141,-26,-16,0.447664767175321,0.44114429681658435,0.11119093600809468,0.4380271397338016,0.45325378006586814,0.10871908020033035,1,1,2,1,4,1,0
515,463,480,-52,-35,0.32498931223980276,0.5570393761010195,0.11797131165917767,0.41556169472655174,0.4633512076197617,0.1210870976536862,0,1,4,1,1,1,0
295,259,271,-36,-24,0.41811095822969063,0.46437732619039973,0.11751171557990973,0.44682661465805884,0.4363705583259079,0.11680282701603337,0,0,1,2,0,1,0
351,235,290,-116,-61,0.4635618740427467,0.4239717598225004,0.11246636613475282,0.4326549267414336,0.46989483285759526,0.09745024040097132,1,1,1,1,4,1,0
312,275,327,-37,15,0.4631804193367106,0.41650483241470654,0.12031474824858299,0.4643552618120681,0.3939789041492721,0.14166583403865965,1,0,1,1,2,0,0
372,187,323,-185,-49,0.4793629432108311,0.4020833662085526,0.1185536905806164,0.5435351026390012,0.3317268097616022,0.12473808759939672,1,1,3,1,4,1,0
363,240,299,-123,-64,0.4220221275590468,0.46714572955179984,0.11083214288915302,0.357791471578953,0.531496289807208,0.11071223861383904,0,1,1,1,1,1,0
220,177,197,-43,-23,0.47891940777380837,0.40638604879486284,0.11469454343132889,0.4241821782559824,0.46063831284403206,0.11517950889998547,1,1,1,1,4,1,0
374,283,364,-91,-10,0.43920383481939557,0.44421790588342475,0.11657825929717966,0.5075424844789986,0.3836890168211056,0.10876849869989562,1,1,1,2,4,1,0
360,254,329,-106,-31,0.4996105427018911,0.3828719879222094,0.11751746937589976,0.44449569891230606,0.43625467675660706,0.11924962433108666,0,1,1,1,1,1,0
150,26,48,-124,-102,0.44125577404000677,0.44563233117532264,0.1131118947846707,0.43184651656793377,0.4401451200472795,0.12800836338478686,0,1,1,1,1,1,0
247,130,201,-117,-46,0.4488488804460774,0.43809309422709375,0.11305802532682871,0.464031011066078,0.4214380971065491,0.11453089182737276,0,1,4,1,1,1,0
187,57,120,-130,-67,0.4574609044020748,0.42702818048516317,0.11551091511276214,0.507865713806525,0.35066993852232736,0.14146434767114796,1,1,2,1,4,1,0
264,133,151,-131,-113,0.48450657872739616,0.39964402731119136,0.11584939396141258,0.31694936038717925,0.5629258734434659,0.12012476616935462,0,1,1,1,1,1,0
352,278,367,-74,15,0.4748163758812908,0.4100551541470549,0.11512846997165414,0.3917840051050878,0.48240245158946204,0.12581354330545,1,1,1,1,4,0,0
444,306,345,-138,-99,0.4274467182318234,0.4566729117136921,0.11588037005448452,0.3944030995960479,0.48802301164615197,0.11757388875780025,1,1,1,1,4,1,0
238,176,199,-62,-39,0.4753298503944472,0.4113958461801285,0.11327430342542416,0.41064570901916425,0.47398249635237827,0.11537179462845755,1,1,1,1,4,1,0
314,270,297,-44,-17,0.4355793985234791,0.45084471302745616,0.11357588844906488,0.4563624540716627,0.407032026432091,0.1366055194962462,0,1,1,1,1,1,0
282,295,313,13,31,0.392713148021335,0.4962334145514848,0.11105343742717991,0.42824996834857837,0.4210168390420814,0.1507331926093401,1,1,2,1,4,0,1
293,216,270,-77,-23,0.45437596411380515,0.4309086655003895,0.11471537038580537,0.40986255654961845,0.4748154471865931,0.11532199626378821,1,1,1,2,4,1,0
271,107,246,-164,-25,0.45678563461916605,0.42880353321307874,0.11441083216775526,0.4667603596370636,0.4102925828556712,0.12294705750726512,0,1,1,1,1,1,0
508,298,316,-210,-192,0.4232123065725409,0.45148481946879804,0.1253028739586612,0.4339237421061068,0.42466923843998317,0.14140701945390974,0,1,1,3,1,1,0
266,157,163,-109,-103,0.4447603985352515,0.44212198255362645,0.11311761891112204,0.3907126075904085,0.5104857901704286,0.09880160223916305,1,1,3,2,4,1,0
235,182,219,-53,-16,0.43835037941738286,0.4468932652863793,0.11475635529623794,0.48524911373496865,0.37887553745710245,0.13587534880792881,0,1,3,3,1,1,0
247,194,225,-53,-22,0.42081463281576914,0.46912547194684306,0.11005989523738771,0.4717743784478494,0.4077760754404472,0.12044954611170314,0,1,3,3,1,1,0
455,371,390,-84,-65,0.4624300710759447,0.422511231118441,0.11505869780561451,0.32943585457380364,0.5547200879602026,0.11584405746599356,0,1,1,2,1,1,0
222,270,376,48,154,0.41702722906566897,0.47008046061916137,0.11289231031516964,0.36276316833981903,0.5286575836402851,0.10857924801989571,0,1,2,2,1,0,1
363,294,326,-69,-37,0.5553635650264123,0.33205086975643866,0.11258556521714909,0.4442541321668763,0.435632414092321,0.12011345374080276,0,1,2,1,1,1,0
440,334,347,-106,-93,0.4147551771317062,0.47393583857810445,0.11130898429018903,0.4957407227771171,0.3985918548444921,0.10566742237839064,0,1,2,1,1,1,0
419,256,408,-163,-11,0.4547622966193494,0.4319688119291011,0.11326889145154949,0.4296646332323644,0.45315469052246465,0.11718067624517083,0,1,1,2,1,1,0
309,251,294,-58,-15,0.45416377599210017,0.43219533301134827,0.11364089099655111,0.4214507790627117,0.4479965728939739,0.13055264804331418,1,1,2,1,4,1,0
160,0,141,-160,-19,0.4447960869387069,0.44200887108444425,0.11319504197684871,0.5046185379764574,0.38497618019578195,0.1104052818277609,1,1,1,1,4,1,0
205,0,151,-205,-54,0.5144528661225176,0.3738957244589911,0.11165140941849137,0.4925145923653916,0.3844555558740248,0.12302985176058324,0,1,1,1,1,1,0
332,186,281,-146,-51,0.4188424805666409,0.4682131293597302,0.11294439007362886,0.36003639131631604,0.5106504506986931,0.12931315798499066,1,1,1,1,4,1,0
285,310,343,25,58,0.4662448523157863,0.4209143728555434,0.11284077482867023,0.47298786277504457,0.42839622026832025,0.09861591695663498,1,1,2,1,4,0,1
262,197,213,-65,-49,0.4289485793562617,0.4575622305010813,0.11348919014265708,0.4415623480949468,0.43925172527670137,0.11918592662835177,0,1,2,1,1,1,0
315,175,241,-140,-74,0.4226529069837315,0.46460037560230005,0.11274671741396881,0.43925361616577585,0.4423600092792064,0.11838637455501756,1,1,2,1,4,1,0
329,100,159,-229,-170,0.4393181116345896,0.44770066661838004,0.11298122174703047,0.3347106964047906,0.5112332750783758,0.15405602851683348,1,1,1,2,4,1,0
307,241,265,-66,-42,0.5264194789530904,0.36357016270237835,0.11001035834453138,0.4991079623166907,0.4060826153045915,0.09480942237871784,0,1,1,1,1,1,0
264,174,249,-90,-15,0.46565227019726274,0.42173012301721635,0.11261760678552103,0.48770180437718913,0.40558931253316716,0.10670888308964377,1,1,2,1,4,1,0
285,216,242,-69,-43,0.48228512406457696,0.4060462702278519,0.11166860570757133,0.4498791439969543,0.43118900173937397,0.11893185426367169,0,1,2,2,1,1,0
381,282,317,-99,-64,0.4535411891865091,0.4259934057748499,0.12046540503864109,0.5131301004363664,0.35291986932008074,0.13395003024355273,0,1,3,2,1,1,0
388,304,371,-84,-17,0.43395784510795016,0.449189304436692,0.11685285045535765,0.34274878334944175,0.5392040939045666,0.1180471227459917,1,1,1,4,4,1,0
249,159,208,-90,-41,0.4230896691748119,0.4649011665767458,0.11200916424844246,0.45979062475645605,0.4208042067006657,0.11940516854287833,0,1,2,1,1,1,0
472,406,584,-66,112,0.44769208814505973,0.4376678064817706,0.11464010537316946,0.40613443338038113,0.4841270269250539,0.10973853969456525,1,1,4,2,4,0,0
355,298,331,-57,-24,0.43562879573498076,0.4560177392405858,0.10835346502443327,0.41620745493555034,0.45959263158002883,0.12419991348442092,1,1,2,1,4,1,0
265,70,334,-195,69,0.44622276556665563,0.43907908372018134,0.11469815071316287,0.41180465640778524,0.4723168032537367,0.11587854033847785,1,1,1,1,4,0,0
213,186,250,-27,37,0.38188326368050746,0.503934865278858,0.11418187104063447,0.5267169938986576,0.3774322360947071,0.0958507700066354,1,1,1,1,4,0,0
348,204,214,-144,-134,0.4177877410807649,0.4684387157838139,0.11377354313542123,0.5543037033285694,0.33531092536060575,0.11038537131082493,0,1,1,1,1,1,0
291,216,268,-75,-23,0.4745895289427386,0.41884663588270515,0.10656383517455617,0.46198944974931927,0.393181096059459,0.1448294541912215,0,1,1,1,1,1,0
497,222,454,-275,-43,0.501459929985724,0.38834267392369765,0.11019739609057819,0.32236797153510643,0.5330307757204983,0.144601252744395,0,1,1,1,1,1,0
335,261,322,-74,-13,0.3751281127069599,0.5109200453947697,0.1139518418982706,0.40688256878300827,0.49104905762741347,0.10206837358957829,1,1,1,2,4,1,0
322,211,252,-111,-70,0.47506219522951765,0.4129922847494614,0.11194552002102068,0.49161992251704495,0.385313112192311,0.12306696529064384,1,1,1,1,4,1,0
277,59,149,-218,-128,0.4658667872502479,0.420186388225508,0.11394682452424376,0.4851779451415842,0.3939141491577916,0.12090790570062387,0,1,1,1,1,1,0
323,263,304,-60,-19,0.45781383937182574,0.4258552907843427,0.11633086984383188,0.5055822854877687,0.3823298195737949,0.11208789493843639,1,1,3,3,4,1,0
282,189,265,-93,-17,0.5004059565699318,0.38845969358831,0.11113434984175836,0.570668511606868,0.33536274327667515,0.09396874511645681,0,1,1,1,1,1,0
344,297,311,-47,-33,0.4289706708021602,0.4610049979783311,0.11002433121950841,0.4465434906554142,0.4441095760043916,0.10934693334019419,0,1,2,2,1,1,0
270,182,357,-88,87,0.5461428871286707,0.3359532463691566,0.11790386650217258,0.4232720332985198,0.4734441983314211,0.10328376837005925,0,1,1,1,1,0,0
307,312,364,5,57,0.4521906545095335,0.4352396566813394,0.1125696888091273,0.5243907684354356,0.3670645930712474,0.10854463849331707,1,1,3,3,4,0,1
443,459,543,16,100,0.453419197740439,0.4277376877169103,0.11884311454265055,0.3392807851631201,0.5331875280089563,0.12753168682792354,1,1,1,1,4,0,1
430,351,360,-79,-70,0.42828911475108217,0.46124021315708275,0.11047067209183499,0.41492431449370637,0.4718284585842003,0.11324722692209302,1,1,2,2,4,1,0
454,386,422,-68,-32,0.3778925900274348,0.5063647690534329,0.11574264091913249,0.3615992478744689,0.5007877350257298,0.13761301709980123,0,1,3,3,1,1,0
329,287,334,-42,5,0.39080101133569717,0.49451850305054035,0.1146804856137624,0.3676886582073357,0.5072395703311459,0.12507177146151827,1,1,1,2,4,0,0
305,244,293,-61,-12,0.39586851321944416,0.49535218154819266,0.1087793052323631,0.47901466302475026,0.41800631481238126,0.1029790221628684,1,1,1,3,4,1,0
406,384,485,-22,79,0.44329026262945503,0.44398476519914104,0.11272497217140395,0.45868149685209436,0.39520203168306206,0.14611647146484366,1,1,1,1,4,0,0
332,186,285,-146,-47,0.46772073782436285,0.41673093562500796,0.11554832655062922,0.4339736749249356,0.4629523397252551,0.10307398534980909,0,1,2,1,1,1,0
374,308,328,-66,-46,0.4813428579653914,0.40271768714195433,0.11593945489265411,0.3685389625126738,0.5042924968936086,0.12716854059371763,1,1,2,1,4,1,0
286,154,205,-132,-81,0.49088333701838904,0.39665127517025345,0.11246538781135768,0.38285114292324335,0.452028263203639,0.1651205938731174,0,1,2,2,1,1,0
669,320,343,-349,-326,0.4447960869387069,0.44200887108444425,0.11319504197684871,0.5046185379764574,0.38497618019578195,0.1104052818277609,1,1,2,1,4,1,0
277,187,217,-90,-60,0.45760546681209874,0.42557316264619466,0.11682137054170638,0.45068551641838456,0.4280805287292522,0.12123395485236334,1,1,1,1,4,1,0
276,135,231,-141,-45,0.5057420234885562,0.37770686919069496,0.1165511073207486,0.48671932847493443,0.4027110264076246,0.11056964511744093,0,1,1,1,1,1,0
395,282,376,-113,-19,0.40154657048290215,0.4859149204547083,0.11253850906238957,0.42865579338322385,0.45965504742750257,0.11168915918927394,1,1,1,1,4,1,0
266,184,237,-82,-29,0.42186495331312357,0.466895441126577,0.11123960556029928,0.3721666400603879,0.5013502734499514,0.12648308648966072,0,1,1,3,1,1,0
153,176,192,23,39,0.4010065181386898,0.4878342742247865,0.1111592076365237,0.336328116118414,0.5424578328646746,0.1212140510169111,1,1,1,3,4,0,1
329,261,356,-68,27,0.38270173954892306,0.49998054885455706,0.11731771159651998,0.41578580083216843,0.4729871764157838,0.11122702275204754,1,1,1,4,4,0,0
313,386,436,73,123,0.4693022620010304,0.41434781030246215,0.11634992769650734,0.5065096021112196,0.36809794113577704,0.1253924567530033,1,1,1,2,4,0,1
356,248,288,-108,-68,0.4751267133591018,0.40207075425190963,0.12280253238898842,0.4128530700068876,0.4247404699009069,0.16240646009220563,0,1,3,1,1,1,0
339,251,303,-88,-36,0.4524677168174433,0.43353497560073084,0.11399730758182566,0.38975792604191967,0.47510243929635415,0.13513963466172624,1,1,1,2,4,1,0
369,141,278,-228,-91,0.4485364068678547,0.4400600986726073,0.11140349445953791,0.49984219823619574,0.4016440952664923,0.09851370649731209,0,1,3,1,1,1,0
316,300,325,-16,9,0.4767334309349882,0.4099588842595178,0.11330768480549389,0.35827035082294456,0.5075921824210807,0.1341374667559748,1,1,1,3,4,0,0
216,159,182,-57,-34,0.49761666961679735,0.3845009734670311,0.11788235691617144,0.4084057204297974,0.4580379406953268,0.13355633887487592,0,1,2,4,1,1,0
265,121,215,-144,-50,0.4675466238549925,0.4194675994725335,0.11298577667247418,0.4427033138965669,0.447771409214793,0.10952527688864012,0,1,1,1,1,1,0
399,354,365,-45,-34,0.45266156191098444,0.43655970931705634,0.11077872877195942,0.33462696933177694,0.5354727868129214,0.12990024385530163,1,1,2,2,4,1,0
338,226,241,-112,-97,0.4652102781713653,0.42131546030465816,0.11347426152397634,0.3598664371339569,0.47516763446250954,0.1649659284035337,0,1,1,2,1,1,0
298,230,272,-68,-26,0.40196361498125904,0.48918362610226473,0.10885275891647604,0.5267249986327923,0.37174107296253955,0.1015339284046681,1,1,2,1,4,1,0
260,127,217,-133,-43,0.438512406429321,0.443930336617467,0.11755725695321204,0.4691175960079656,0.4191691399760788,0.11171326401595566,1,1,2,1,4,1,0
345,249,326,-96,-19,0.39434853731082853,0.49034887543132577,0.11530258725784574,0.32475062132257426,0.5674830618877895,0.10776631678963602,1,1,2,2,4,1,0
264,129,166,-135,-98,0.4959036529939294,0.3880475228922467,0.11604882411382383,0.4418311386460962,0.4365726547306496,0.12159620662325396,1,1,2,1,4,1,0
295,306,334,11,39,0.4517920421716079,0.423994615166477,0.12421334266191539,0.33799579538385655,0.5294196141598005,0.1325845904563432,1,1,1,1,4,0,1
316,247,306,-69,-10,0.46471967016818627,0.42186927979239297,0.11341105003942088,0.4238521758091773,0.44646876856778794,0.12967905562303486,1,1,1,1,4,1,0
204,215,315,11,111,0.4431300027959771,0.44530048584661136,0.11156951135741137,0.48721270411109047,0.3987004351806533,0.1140868607082564,1,1,1,1,4,0,1
329,257,296,-72,-33,0.41871562187757855,0.46754409791533347,0.1137402802070876,0.4506177643430735,0.41854564427029034,0.1308365913866364,1,1,1,2,4,1,0
148,21,189,-127,41,0.5162879310017703,0.3694968530502445,0.11421521594798544,0.4909408442840373,0.3826400767352049,0.12641907898075783,1,1,1,1,4,0,0
310,204,296,-106,-14,0.42176833457810037,0.46079729150345805,0.11743437391844161,0.4725503138911444,0.40967014217584136,0.11777954393301439,1,1,1,1,4,1,0
366,296,338,-70,-28,0.4400962796793569,0.4438244442549014,0.11607927606574168,0.4531931366316066,0.42757848930324116,0.11922837406515195,1,1,1,2,4,1,0
274,82,124,-192,-150,0.4198910803075094,0.46792356552001535,0.11218535417247556,0.5036732521143689,0.3862280104873067,0.11009873739832413,0,1,1,2,1,1,0
404,0,100,-404,-304,0.4430418564915355,0.4434926729644038,0.11346547054406053,0.254094180868735,0.6283744970142688,0.11753132211699603,1,1,1,1,4,1,0
276,199,263,-77,-13,0.41903420103323374,0.47041086417429,0.11055493479247631,0.2776777630181161,0.6051693527969706,0.11715288418491339,0,1,1,1,1,1,0
274,226,236,-48,-38,0.4888766405157907,0.3977689730851128,0.11335438639909619,0.38463135545226096,0.4970675196396658,0.11830112490807317,1,1,1,1,4,1,0
389,308,340,-81,-49,0.4513785055220143,0.4319393614695002,0.11668213300848558,0.47808487309551145,0.40567080919954285,0.11624431770494564,0,1,3,2,1,1,0
294,308,340,14,46,0.4490232519547818,0.4374532561344137,0.11352349191080445,0.47814912334426,0.4087130804656569,0.1131377961900829,1,1,3,2,4,0,1
314,30,112,-284,-202,0.5140254376441069,0.3696556813875686,0.11631888096832439,0.47295017392976035,0.40193926577668865,0.12511056029355083,1,1,1,1,4,1,0
255,197,205,-58,-50,0.4749331135119671,0.4113428855330176,0.11372400095501516,0.4777979682447655,0.3976106536085851,0.12459137814664903,0,1,2,1,1,1,0
79,0,58,-79,-21,0.4447960869387069,0.44200887108444425,0.11319504197684871,0.5046185379764574,0.38497618019578195,0.1104052818277609,1,1,1,1,4,1,0
141,39,105,-102,-36,0.44593755301066995,0.44065395600411544,0.11340849098521476,0.5032283936336337,0.38608420408298205,0.11068740228338425,1,1,2,1,4,1,0
71,0,21,-71,-50,0.4447960869387069,0.44200887108444425,0.11319504197684871,0.5046185379764574,0.38497618019578195,0.1104052818277609,1,1,2,1,4,1,0
679,567,649,-112,-30,0.5108209141978913,0.37520078502191495,0.11397830078019329,0.43783941961522166,0.462731388396116,0.09942919198866226,1,1,2,1,4,1,0
507,374,466,-133,-41,0.37356891130425063,0.5154344972498229,0.11099659144592659,0.3819899110451096,0.4957791148174284,0.122230974137462,1,1,2,1,4,1,0
252,213,243,-39,-9,0.42097984067896943,0.46600650417614736,0.11301365514488314,0.4315965573550061,0.4553218347327998,0.11308160791219407,1,1,1,2,4,1,0
382,183,225,-199,-157,0.4661852883207283,0.42252306959159824,0.11129164208767359,0.4222301914334566,0.474029528155026,0.1037402804115175,1,1,1,1,4,1,0
261,148,168,-113,-93,0.41885793536814964,0.4687472388664249,0.11239482576542525,0.4668816730907324,0.4197420835092204,0.11337624340004744,1,1,1,1,4,1,0
145,0,238,-145,93,0.4608325226520991,0.42417530321066943,0.11499217413723149,0.514103361298794,0.3734269288595423,0.11246970984166363,1,1,1,1,4,0,0
133,173,184,40,51,0.49769706183137213,0.38880287138967207,0.11350006677895581,0.5135735242357639,0.3623838613882082,0.12404261437602795,1,1,2,1,4,0,1
282,225,247,-57,-35,0.45268408580120706,0.4332351010310607,0.11408081316773229,0.5195756731266257,0.35777083406778953,0.12265349280558475,0,1,1,3,1,1,0
244,230,355,-14,111,0.45176228789821044,0.4343742541042468,0.11386345799754281,0.44184983862356,0.43820394291259346,0.11994621846384652,0,1,1,2,1,0,0
395,255,277,-140,-118,0.4127988154136049,0.4711126052463232,0.11608857934007186,0.4779943159516464,0.4075816927639071,0.11442399128444639,0,1,2,1,1,1,0
275,138,150,-137,-125,0.4830293984345485,0.4034675068217713,0.11350309474368016,0.48985944292863126,0.3697259891758665,0.14041456789550227,0,1,2,1,1,1,0
376,237,299,-139,-77,0.5139902441948064,0.3726591799855491,0.11335057581964444,0.46016969385192247,0.44893234287106004,0.09089796327701763,1,1,2,1,4,1,0
267,234,252,-33,-15,0.4880398168137576,0.397152575178475,0.11480760800776725,0.4072546420916801,0.4707737841050844,0.12197157380323582,0,1,1,1,1,1,0
259,103,158,-156,-101,0.44402653785844726,0.44311925847634753,0.11285420366520503,0.4428110922920933,0.4188235538517577,0.13836535385614906,0,1,1,2,1,1,0
348,270,333,-78,-15,0.49577240708327114,0.38790308429098386,0.11632450862574492,0.45958388647881865,0.406828975296618,0.13358713822456353,0,1,3,1,1,1,0
261,102,154,-159,-107,0.48598739590107004,0.39880586020604447,0.11520674389288538,0.44925435282652537,0.4303932479584764,0.12035239921499816,1,1,1,1,4,1,0
284,183,215,-101,-69,0.4152888601660559,0.474864083864751,0.10984705596919278,0.28487886492784964,0.5840430953436345,0.13107803972851614,0,1,1,2,1,1,0
390,323,351,-67,-39,0.46560064858198563,0.4229600359301424,0.11143931548787168,0.4510696639105528,0.4358720380678339,0.11305829802161313,0,1,1,1,1,1,0
404,339,392,-65,-12,0.4463449453084964,0.4427206119297169,0.11093444276178659,0.4192681855303407,0.43768855540583407,0.1430432590638254,1,1,3,2,4,1,0
345,178,362,-167,17,0.45987241254430505,0.431522614821811,0.10860497263388391,0.4360822095434082,0.460673367610601,0.10324442284599077,1,1,1,2,4,0,0
318,231,260,-87,-58,0.46494500900463775,0.41819482050561835,0.11686017048974393,0.5260351914902094,0.3612048421746596,0.11275996633513109,0,1,2,3,1,1,0
443,369,379,-74,-64,0.4169689402504329,0.47492458467302473,0.10810647507654227,0.34615097091459107,0.5506664591920049,0.10318256989340427,1,1,4,5,4,1,0
356,245,327,-111,-29,0.48802849907022033,0.4002890911867031,0.11168240974307636,0.5374174705365595,0.3516944579863975,0.11088807147704297,1,1,1,1,4,1,0
397,161,292,-236,-105,0.5120925563400681,0.37853496484860705,0.10937247881132459,0.537156176044459,0.3423687618778642,0.12047506207767701,0,1,1,1,1,1,0
254,207,226,-47,-28,0.4450352015163192,0.44354191539001564,0.11142288309366513,0.4680799796431151,0.42741697888421454,0.10450304147267031,1,1,1,1,4,1,0
239,169,196,-70,-43,0.340668219951023,0.5496220371748128,0.10970974287416407,0.35856404774892087,0.5196135500295427,0.12182240222153616,1,1,1,1,4,1,0
368,281,346,-87,-22,0.519497692217049,0.363119510404734,0.11738279737821701,0.5173853498844568,0.37109048464476097,0.11152416547078224,1,1,2,1,4,1,0
337,285,302,-52,-35,0.47731215087949297,0.4077986182542075,0.11488923086629957,0.49951774522541,0.36896374625904327,0.1315185085155466,0,1,2,1,1,1,0
411,236,271,-175,-140,0.4305675398992136,0.4592032454311564,0.11022921466963023,0.5349667482353871,0.34254380756261116,0.1224894442020018,1,1,3,1,4,1,0
137,65,81,-72,-56,0.4447960869387069,0.44200887108444425,0.11319504197684871,0.5046185379764574,0.38497618019578195,0.1104052818277609,1,1,1,1,4,1,0
287,149,265,-138,-22,0.5172398403346512,0.3660518831683124,0.1167082764970364,0.3997084296155416,0.490472039748928,0.10981953063553042,1,1,1,1,4,1,0
329,174,258,-155,-71,0.4049705911978463,0.48383029153143436,0.1111991172707193,0.4071751430700516,0.46732900706322883,0.12549584986671958,0,1,2,3,1,1,0
158,175,228,17,70,0.38275937309066993,0.507414001775454,0.10982662513387607,0.43799674293147123,0.46316663186886947,0.09883662519965919,1,1,1,1,4,0,1
6,61,188,55,182,0.4447960869387069,0.44200887108444425,0.11319504197684871,0.5046185379764574,0.38497618019578195,0.1104052818277609,1,1,1,1,4,0,1
167,200,361,33,194,0.44524436098894066,0.4403171361804809,0.11443850283057824,0.5295766069472039,0.36830378504988387,0.10211960800291223,1,1,1,1,4,0,1
417,380,403,-37,-14,0.47361484757901134,0.41017391388630364,0.11621123853468487,0.4171715303373326,0.4659413489485802,0.11688712071408681,0,1,3,1,1,1,0
350,333,341,-17,-9,0.5116654759646708,0.3699575631711262,0.11837696086420281,0.4652043223821262,0.4129690286373388,0.12182664898053495,1,1,1,3,4,1,0
256,186,225,-70,-31,0.4255551244363489,0.45993784068572685,0.11450703487792446,0.36977254061663967,0.5165400038363774,0.11368745554698327,0,1,1,1,1,1,0
337,250,318,-87,-19,0.3758366908017529,0.5078314494847733,0.11633185971347393,0.4871459257999681,0.3983122673641894,0.11454180683584235,0,1,6,4,1,1,0
198,0,212,-198,14,0.5086173467042322,0.37661127191881283,0.11477138137695514,0.4337736012196545,0.45436691773472754,0.11185948104561787,0,1,1,1,1,0,0
140,73,199,-67,59,0.45422333912237317,0.43532880207066293,0.11044785880696394,0.48639928671166244,0.40801704884136514,0.10558366444697229,0,1,2,1,1,0,0
430,350,375,-80,-55,0.4401537246936314,0.4492568918364661,0.11058938346990256,0.21368647838224,0.6588920112452438,0.12742151037251598,1,1,1,2,4,1,0
504,444,480,-60,-24,0.361270055809009,0.5232280859163605,0.11550185827463073,0.28326621601184143,0.5641051410676143,0.15262864292054407,0,1,1,3,1,1,0
539,384,455,-155,-84,0.4192109478044394,0.46812839623117186,0.11266065596438846,0.4554382525523487,0.4382945775571232,0.10626716989052815,1,1,1,1,4,1,0
267,202,248,-65,-19,0.4084563200248082,0.4816935315936845,0.10985014838150726,0.4930017720895208,0.3897763558367391,0.11722187207373999,1,1,1,1,4,1,0
268,16,88,-252,-180,0.4447960869387069,0.44200887108444425,0.11319504197684871,0.5046185379764574,0.38497618019578195,0.1104052818277609,0,1,1,1,1,1,0
244,102,136,-142,-108,0.4228323383803811,0.4635216858081414,0.11364597581147738,0.49207455728557414,0.40659607261993974,0.10132937009448616,0,1,1,1,1,1,0
272,138,218,-134,-54,0.42855732223047904,0.4584920776780347,0.11295060009148634,0.4766275260182078,0.41144915050009945,0.11192332348169283,1,1,2,2,4,1,0
166,57,129,-109,-37,0.4380368826464046,0.4491253134771663,0.11283780387642901,0.5288061641477191,0.3647395661529931,0.10645426969928802,0,1,1,1,1,1,0
676,551,654,-125,-22,0.4411475278135933,0.4478267046058402,0.11102576758056655,0.46707101845856264,0.4157971272032838,0.1171318543381533,0,1,3,1,1,1,0
313,203,228,-110,-85,0.4648564487095882,0.4235953297647492,0.11154822152566259,0.48859807051041504,0.3988991454047967,0.11250278408478845,1,1,1,2,4,1,0
978,536,953,-442,-25,0.37360688695577793,0.5177392184178999,0.10865389462632202,0.39330532590449346,0.5009747430182041,0.10571993107730228,1,1,1,1,4,1,0
351,207,223,-144,-128,0.41659309955373897,0.4684183056350492,0.11498859481121164,0.41825065236664677,0.45628594504061176,0.1254634025927413,0,1,2,3,1,1,0
293,190,205,-103,-88,0.41182191296495285,0.4758290503886565,0.11234903664639044,0.4055152117759548,0.4811067015722982,0.1133780866517469,0,1,3,1,1,1,0
240,257,290,17,50,0.48991538970176335,0.3989102220361732,0.11117438826206333,0.5637585179312437,0.3369470053322669,0.09929447673648928,1,1,1,1,4,0,1
348,206,298,-142,-50,0.4819271359776481,0.400693865299572,0.11737899872277978,0.48774933460472103,0.40675472379689254,0.10549594159838668,1,1,1,3,4,1,0
279,98,176,-181,-103,0.4373543684767881,0.4480950286984103,0.11455060282480159,0.2956055267769708,0.5909184215164449,0.11347605170658451,0,1,2,1,1,1,0
406,279,435,-127,29,0.4134400160758242,0.4735208955711929,0.11303908835298272,0.37713208066244713,0.5163763770187895,0.10649154231876352,1,1,3,1,4,0,0
325,345,363,20,38,0.41995301647044364,0.47180743916782875,0.10823954436172746,0.349451841025885,0.511197242566009,0.13935091640810615,0,1,1,2,1,0,1
419,307,379,-112,-40,0.4043963570330285,0.47923584299520944,0.11636779997176222,0.3056092506101978,0.5665633684303141,0.1278273809594879,1,1,1,3,4,1,0
266,181,212,-85,-54,0.43869910718487143,0.4481015752047573,0.11319931761037125,0.37676811231853585,0.5121943325189454,0.11103755516251869,1,1,1,2,4,1,0
319,217,246,-102,-73,0.4420334879955238,0.44720477949100396,0.11076173251347261,0.47104639849946955,0.40832050104097417,0.12063310045955619,1,1,2,2,4,1,0
292,218,248,-74,-44,0.41788426124735417,0.4679924762415234,0.11412326251112238,0.5213297494254626,0.37276417130905504,0.1059060792654824,0,1,1,1,1,1,0
378,46,343,-332,-35,0.4447960869387069,0.44200887108444425,0.11319504197684871,0.5046185379764574,0.38497618019578195,0.1104052818277609,0,1,1,1,1,1,0
236,154,203,-82,-33,0.4310957100438104,0.45740354997023136,0.11150073998595841,0.37590932998149723,0.49071768202588356,0.13337298799261904,1,1,1,2,4,1,0
353,275,302,-78,-51,0.42893360101261185,0.45676364939373476,0.11430274959365357,0.47941634159160756,0.41576128642308896,0.10482237198530366,1,1,3,3,4,1,0
366,218,309,-148,-57,0.47032848308154723,0.4181513575209867,0.11152015939746586,0.499985145568792,0.4032863033094127,0.09672855112179532,0,1,2,1,1,1,0
181,158,172,-23,-9,0.41555864982513235,0.4709325079805777,0.11350884219428993,0.4655866767577315,0.41719837453763736,0.11721494870463103,1,1,3,4,4,1,0
459,319,346,-140,-113,0.5198650846323845,0.3632212584436222,0.1169136569239935,0.5547466926879318,0.3219481340777496,0.1233051732343186,0,1,1,1,1,1,0
384,247,317,-137,-67,0.4814705420750319,0.4054539075242586,0.11307555040070973,0.4369836693917558,0.441104697341969,0.1219116332662752,0,1,1,1,1,1,0
354,160,175,-194,-179,0.45525692139734036,0.4326547891767754,0.11208828942588392,0.4388198262224288,0.4239589440094244,0.13722122976814696,1,1,2,1,4,1,0
262,218,241,-44,-21,0.42012279270601055,0.46432773518881665,0.11554947210517261,0.3356593441850379,0.5156492960230447,0.14869135979191767,1,1,4,3,4,1,0
288,22,232,-266,-56,0.4447960869387069,0.44200887108444425,0.11319504197684871,0.5046185379764574,0.38497618019578195,0.1104052818277609,1,1,1,1,4,1,0
298,214,260,-84,-38,0.4447960869387069,0.44200887108444425,0.11319504197684871,0.5046185379764574,0.38497618019578195,0.1104052818277609,1,1,2,1,4,1,0
314,176,271,-138,-43,0.44404151876445147,0.4440615033321502,0.11189697790339864,0.4244270967433697,0.46612146703039464,0.1094514362262355,0,1,2,1,1,1,0
114,97,128,-17,14,0.4681317566553964,0.41775764279537275,0.11411060054923068,0.42599619810743666,0.45105725022269755,0.12294655166986583,1,1,1,2,4,0,0
313,152,289,-161,-24,0.47793984708453896,0.4075365816125314,0.11452357130292987,0.5144557164502358,0.37259782607969094,0.11294645747007323,1,1,1,1,4,1,0
251,169,296,-82,45,0.47130564283600784,0.4120508948330562,0.11664346233093595,0.44295184367212126,0.4417421029132919,0.11530605341458663,1,1,1,2,4,0,0
247,216,228,-31,-19,0.5028750186591076,0.383556194332134,0.1135687870087582,0.4370827455416195,0.44400334299019983,0.11891391146818078,1,1,1,1,4,1,0
141,0,57,-141,-84,0.46038932468947036,0.42441673565320315,0.11519393965732655,0.4734242111845906,0.4146808350404913,0.11189495377491779,1,1,1,2,4,1,0
347,317,359,-30,12,0.475164075338654,0.4108382821111146,0.11399764255023115,0.3438094885283385,0.531370936275321,0.12481957519634049,1,1,1,4,4,0,0
401,346,371,-55,-30,0.47066932109030163,0.4125377264646487,0.11679295244504961,0.4348026295268207,0.4530451813291096,0.11215218914406971,1,1,1,3,4,1,0
205,177,192,-28,-13,0.4482932269219927,0.4360270605601572,0.11567971251785011,0.4449737495464946,0.4339903800086064,0.12103587044489887,1,1,1,2,4,1,0
245,182,217,-63,-28,0.4196103689900688,0.46890251762243423,0.11148711338749688,0.46711213457896017,0.4113041033389519,0.1215837620820879,1,1,1,1,4,1,0
415,231,373,-184,-42,0.43930409965690176,0.4486723039771674,0.11202359636593061,0.39733175456354286,0.48879485930068267,0.1138733861357747,0,1,1,2,1,1,0
412,253,267,-159,-145,0.5063985088542583,0.3745765747146254,0.11902491643111623,0.40905919781003963,0.4886890084113662,0.10225179377859403,1,1,1,1,4,1,0
238,188,221,-50,-17,0.4344485141887196,0.4486740310834006,0.11687745472788004,0.4693403125172241,0.4270166509703571,0.10364303651241885,1,1,2,2,4,1,0
233,254,320,21,87,0.46391682683167007,0.4230463605390125,0.11303681262931717,0.5061011978209513,0.3923224409535155,0.10157636122553314,1,1,1,2,4,0,1
262,165,223,-97,-39,0.4841080115280233,0.3973500445349053,0.11854194393707124,0.5283939675839647,0.36773198539013635,0.10387404702589897,0,1,1,1,1,1,0
264,175,196,-89,-68,0.44729908903335264,0.44084280911853935,0.11185810184810764,0.4475100725703609,0.43514677810096664,0.11734314932867257,1,1,1,2,4,1,0
279,241,261,-38,-18,0.43021895009214844,0.45532112588488405,0.11445992402296745,0.4219443866340369,0.45601333421356505,0.122042279152398,1,1,1,1,4,1,0
293,195,252,-98,-41,0.47075803747091527,0.41370242477303426,0.11553953775605058,0.4893895273271912,0.38490128103981314,0.12570919163299554,1,1,1,1,4,1,0
414,315,404,-99,-10,0.45005788580114936,0.4336743126896107,0.1162678015092399,0.5040398901384308,0.37250931731660597,0.12345079254496329,1,1,2,3,4,1,0
379,196,219,-183,-160,0.451264453568791,0.4352360156961073,0.11349953073510174,0.41355569145582166,0.46630140193399955,0.12014290661017876,0,1,2,1,1,1,0
246,124,152,-122,-94,0.4697067927113004,0.4147536607800447,0.11553954650865493,0.46439842127608055,0.4181974618909225,0.11740411683299701,1,1,1,1,4,1,0
154,46,120,-108,-34,0.49385570553839414,0.3895056466034319,0.11663864785817386,0.4680147189565505,0.3956833450320552,0.13630193601139412,0,1,1,1,1,1,0
249,152,222,-97,-27,0.49648866244649736,0.38890858151088037,0.1146027560426221,0.4375098686472936,0.4460566471902312,0.11643348416247541,0,1,3,2,1,1,0
220,149,236,-71,16,0.5221750627588804,0.3628833542569804,0.11494158298413915,0.5208403541239585,0.34288337234913596,0.13627627352690572,1,1,1,2,4,0,0
344,197,292,-147,-52,0.5035068574568733,0.38083833390684,0.11565480863628685,0.511390361350438,0.38830339267206504,0.10030624597749707,1,1,2,1,4,1,0
286,299,320,13,34,0.4381173174952824,0.4473073459562208,0.11457533654849683,0.45119228667583366,0.42749846278146253,0.12130925054270382,0,1,2,2,1,0,1
335,302,319,-33,-16,0.3363964956261473,0.5519094924357426,0.11169401193810992,0.34854805303125,0.5406181480728437,0.1108337988959063,0,1,1,1,1,1,0
281,169,188,-112,-93,0.47117337028705997,0.4142709218456557,0.11455570786728425,0.5073821720433244,0.38625435634781513,0.10636347160886048,0,1,1,1,1,1,0
318,296,355,-22,37,0.5183489224531707,0.36780368231926375,0.11384739522756544,0.6093535392326954,0.27629791945294646,0.11434854131435768,1,1,1,4,4,0,0
407,341,372,-66,-35,0.39620397122251194,0.48862269444738016,0.11517333433010779,0.30635676477602386,0.5604247685795873,0.13321846664438855,0,1,2,3,1,1,0
388,318,356,-70,-32,0.453360743431162,0.43418081385077917,0.11245844271805917,0.4610633618522375,0.418668810832969,0.12026782731479344,1,1,1,2,4,1,0
394,369,384,-25,-10,0.36635178169301524,0.5225755137621195,0.11107270454486513,0.304489470889667,0.5752274969588657,0.1202830321514672,1,1,2,2,4,1,0
234,96,204,-138,-30,0.3930582439598286,0.4918485171703527,0.1150932388698188,0.482416582164347,0.41149530373980375,0.10608811409584902,0,1,1,1,1,1,0
318,278,330,-40,12,0.3908031978280057,0.49735329918267496,0.11184350298931932,0.5262852257651675,0.3607732184839708,0.1129415557508618,1,1,1,1,4,0,0
170,23,78,-147,-92,0.49006693315759203,0.3976269818669471,0.11230608497546066,0.4516707140106822,0.4341196459249822,0.11420964006433569,0,1,1,1,1,1,0
416,441,548,25,132,0.3814190220080533,0.5009352465592599,0.11764573143268699,0.1434961028596412,0.737242048766371,0.11926184837398808,1,1,3,2,4,0,1
271,178,225,-93,-46,0.3854732814209146,0.504990460765644,0.10953625781344148,0.4084010739792145,0.46064803609880023,0.13095088992198542,1,1,1,3,4,1,0
377,389,410,12,33,0.43736214839056453,0.44888409973379856,0.1137537518756367,0.30112409836066023,0.600246640307729,0.09862926133161064,1,1,1,1,4,0,1
313,281,325,-32,12,0.4800223389313105,0.4057880748942545,0.11418958617443475,0.48516997897614506,0.411219737126499,0.10361028389735594,1,1,1,4,4,0,0
331,212,296,-119,-35,0.42908419806378445,0.4576743353580866,0.11324146657812903,0.5219764018192274,0.38178014462510496,0.09624345355566784,1,1,1,1,4,1,0
307,244,265,-63,-42,0.4534954491099301,0.432751582320998,0.11375296856907156,0.4016011808997492,0.48206119969177275,0.1163376194084776,1,1,2,1,4,1,0
310,322,370,12,60,0.45914485633804397,0.4295367986751482,0.11131834498680769,0.5187009415080386,0.37675290204944406,0.10454615644251739,1,1,1,3,4,0,1
103,52,96,-51,-7,0.45243451110747895,0.4351523429389192,0.11241314595360165,0.4701121784692454,0.41493782087043757,0.1149500006603169,0,1,2,1,1,1,0
417,333,379,-84,-38,0.4715329436720249,0.4137990950815715,0.11466796124640356,0.27592105121812743,0.5801947020563536,0.14388424672551892,1,1,2,1,4,1,0
266,160,179,-106,-87,0.4009042164800453,0.4846691622588121,0.11442662126114254,0.45790128838744,0.4215258900838097,0.1205728215287503,1,1,3,2,4,1,0
463,41,105,-422,-358,0.42384880921639106,0.4589578209088595,0.11719336987474932,0.18267280223510265,0.6719167917157466,0.14541040604915093,1,1,1,1,4,1,0
296,264,284,-32,-12,0.4622916912496973,0.4264655291565371,0.11124277959376541,0.3184047771182548,0.5551742447739487,0.12642097810779643,0,1,1,1,1,1,0
69,28,55,-41,-14,0.4447960869387069,0.44200887108444425,0.11319504197684871,0.5046185379764574,0.38497618019578195,0.1104052818277609,1,1,1,1,4,1,0
272,322,331,50,59,0.4652103039652234,0.4239285851435309,0.11086111089124577,0.5223939612216731,0.37556569059501754,0.10204034818330922,1,1,1,2,4,0,1
240,270,297,30,57,0.4920736500084932,0.3947297255018238,0.11319662448968273,0.48070320423995494,0.40602129070023824,0.11327550505980676,1,1,3,3,4,0,1
325,239,273,-86,-52,0.48332483803013854,0.3992282146041541,0.11744694736570702,0.43426456859598805,0.443235158076268,0.12250027332774384,0,1,2,2,1,1,0
301,265,281,-36,-20,0.4210579771571586,0.4669151847253456,0.11202683811749568,0.4132178668577096,0.4328007847654659,0.15398134837682448,1,1,1,1,4,1,0
318,226,257,-92,-61,0.47654605602529065,0.4049699196011005,0.11848402437360887,0.3633056906830581,0.5030131359928754,0.13368117332406657,1,1,1,3,4,1,0
400,263,320,-137,-80,0.42889755065998675,0.45549978695566423,0.11560266238434902,0.37673422008899027,0.4909617014177712,0.13230407849323822,0,1,3,1,1,1,0
505,358,528,-147,23,0.48484311665697283,0.3977165220115831,0.11744036133144409,0.3918691240930932,0.4789428569573425,0.1291880189495644,0,1,2,1,1,0,0
498,451,482,-47,-16,0.43891635609325885,0.4453870540339618,0.11569658987277914,0.42087082075119386,0.44954895826930635,0.12958022097949962,0,1,1,1,1,1,0
339,249,274,-90,-65,0.47670136754371784,0.4084128445355307,0.11488578792075153,0.4283709082815702,0.43922754215939436,0.13240154955903546,1,1,1,3,4,1,0
142,0,49,-142,-93,0.46738919415561253,0.41825285275443874,0.11435795308994899,0.4529321541443974,0.4421834732872402,0.10488437256836226,0,1,1,1,1,1,0
274,72,131,-202,-143,0.42159106006277736,0.46464041906081227,0.11376852087641039,0.31514112388936477,0.5405468670884359,0.14431200902219962,1,1,1,1,4,1,0
225,76,213,-149,-12,0.4447960869387069,0.44200887108444425,0.11319504197684871,0.5046185379764574,0.38497618019578195,0.1104052818277609,1,1,1,1,4,1,0
269,302,349,33,80,0.47675454668659073,0.40661557100938633,0.11662988230402294,0.41299308856412387,0.4566146680851546,0.13039224335072114,1,1,2,1,4,0,1
273,80,155,-193,-118,0.4234884091320639,0.46178217127734805,0.11472941959058795,0.43146290663523523,0.4508387033946037,0.11769838997016116,1,1,1,1,4,1,0
337,252,266,-85,-71,0.42228508315766883,0.46742177073929764,0.11029314610303341,0.48863874294395837,0.3878544883057162,0.12350676875032515,1,1,1,1,4,1,0
320,217,260,-103,-60,0.4667075154040353,0.4208592865218668,0.11243319807409807,0.4015303933964308,0.471425331756034,0.1270442748475351,0,1,1,1,1,1,0
121,5,110,-116,-11,0.4447960869387069,0.44200887108444425,0.11319504197684871,0.5046185379764574,0.38497618019578195,0.1104052818277609,0,1,1,1,1,1,0
341,192,206,-149,-135,0.432989414203793,0.45545424201495777,0.11155634378124948,0.3660073058393224,0.512599565775787,0.12139312838489057,0,1,1,2,1,1,0
528,418,431,-110,-97,0.3969780047550701,0.4958684430263592,0.10715355221857081,0.2758683010972322,0.5963638294531891,0.1277678694495788,1,1,2,1,4,1,0
438,358,365,-80,-73,0.42789112764534154,0.4566301422481997,0.11547873010645886,0.46998439583737883,0.4278804324837414,0.10213517167887966,0,1,6,3,1,1,0
303,257,370,-46,67,0.40420076818409634,0.4878451066841912,0.1079541251317124,0.370613786359939,0.5027628606514597,0.12662335298860092,1,1,1,1,4,0,0
251,87,168,-164,-83,0.4804577701535781,0.4077376013290647,0.11180462851735745,0.49508001117575423,0.38137348076211763,0.12354650806212786,0,1,2,1,1,1,0
104,0,32,-104,-72,0.44833573844304264,0.4384996116914623,0.11316464986549471,0.4704949076849377,0.4096149049022103,0.11989018741285197,1,1,1,1,4,1,0
415,294,317,-121,-98,0.4186903575163262,0.4650708328077487,0.11623880967592493,0.4110911458148008,0.49944024836599404,0.08946860581920502,0,1,3,1,1,1,0
156,0,71,-156,-85,0.4447960869387069,0.44200887108444425,0.11319504197684871,0.5046185379764574,0.38497618019578195,0.1104052818277609,1,1,1,1,4,1,0
126,0,94,-126,-32,0.4533775844484568,0.4353183423201686,0.11130407323137453,0.48960900383453115,0.3973902807592783,0.11300071540619071,1,1,2,1,4,1,0
298,131,166,-167,-132,0.43185712591055225,0.4545981972764737,0.11354467681297395,0.4898178158610068,0.40429079112637534,0.10589139301261777,1,1,3,1,4,1,0
298,229,281,-69,-17,0.4217924441294284,0.46367450644159214,0.11453304942897952,0.4570161300755862,0.39576044829066953,0.14722342163374433,0,1,1,2,1,1,0
348,370,431,22,83,0.45212084824049786,0.43312551119173376,0.11475364056776868,0.48802446658345383,0.4059440221451556,0.10603151127139045,1,1,2,2,4,0,1
373,249,306,-124,-67,0.5211998798341902,0.35975615209550527,0.11904396807030444,0.3421090960502897,0.5003969849991847,0.15749391895052525,0,1,1,1,1,1,0
460,255,278,-205,-182,0.4597419883259128,0.42431298433382425,0.11594502734026288,0.35840972723387465,0.5217817353698547,0.11980853739627052,1,1,1,2,4,1,0
296,206,246,-90,-50,0.46467940052496637,0.4219507427147801,0.11336985676025375,0.34079419030057145,0.529677974957407,0.1295278347420215,0,1,1,2,1,1,0
310,250,283,-60,-27,0.44845242892804155,0.4354010800646022,0.11614649100735633,0.48764560247170596,0.39322875457924816,0.11912564294904597,0,1,2,3,1,1,0
254,170,229,-84,-25,0.4492946741374616,0.432484247159191,0.1182210787033477,0.471303132827384,0.4211558548660517,0.10754101230656425,1,1,1,1,4,1,0
426,258,337,-168,-89,0.4308366156652902,0.4553175199010761,0.1138458644336337,0.4370635423000076,0.4637304804722855,0.09920597722770684,0,1,1,1,1,1,0
320,249,267,-71,-53,0.4447960869387069,0.44200887108444425,0.11319504197684871,0.5046185379764574,0.38497618019578195,0.1104052818277609,1,1,1,1,4,1,0
335,369,378,34,43,0.47136516897818953,0.4125294046587934,0.11610542636301727,0.47275300527465197,0.4314931631500607,0.09575383157528743,0,1,2,2,1,0,1
124,0,86,-124,-38,0.4447960869387069,0.44200887108444425,0.11319504197684871,0.5046185379764574,0.38497618019578195,0.1104052818277609,1,1,1,1,4,1,0
13,25,45,12,32,0.4447960869387069,0.44200887108444425,0.11319504197684871,0.5046185379764574,0.38497618019578195,0.1104052818277609,1,1,1,1,4,0,1
112,25,45,-87,-67,0.4447960869387069,0.44200887108444425,0.11319504197684871,0.5046185379764574,0.38497618019578195,0.1104052818277609,0,1,1,1,1,1,0
310,167,292,-143,-18,0.5049445663049541,0.381290984601633,0.11376444909341253,0.4886830997653025,0.3904056859845587,0.12091121425013848,1,1,1,1,4,1,0
287,132,439,-155,152,0.39952835525871194,0.4886197233071649,0.11185192143412295,0.2826276692031923,0.5559879284428837,0.1613844023539237,0,1,1,1,1,0,0
304,270,281,-34,-23,0.3911689801410446,0.4998405357416059,0.10899048411734924,0.26941797622091956,0.6081441750137668,0.12243784876531365,1,1,2,2,4,1,0
329,253,277,-76,-52,0.42341430492027454,0.46099143820564664,0.1155942568740789,0.34688439716780706,0.5316903728716182,0.12142522996057503,0,1,3,5,1,1,0
271,172,247,-99,-24,0.4487094749307869,0.44071291310149857,0.11057761196771411,0.47742992825924785,0.4126719971104365,0.10989807463031574,1,1,1,2,4,1,0
304,231,270,-73,-34,0.43874395701572727,0.44854144823881165,0.11271459474546104,0.40844175736873395,0.4870641293450473,0.10449411328621863,1,1,1,1,4,1,0
286,331,354,45,68,0.4480888628245032,0.4437184112259679,0.10819272594952886,0.4097971907164296,0.46087317505317266,0.1293296342303978,1,1,5,1,4,0,1
309,267,295,-42,-14,0.44184543031459395,0.4448872871120508,0.11326728257335496,0.4908047354325428,0.3948925455138241,0.11430271905363296,0,1,4,4,1,1,0
270,224,240,-46,-30,0.39723419676724775,0.4885621644343448,0.11420363879840739,0.507229144973739,0.39016752796583376,0.10260332706042699,1,1,1,1,4,1,0
289,207,238,-82,-51,0.45643069953908993,0.42990170043729115,0.1136676000236188,0.4404425431279382,0.42361857729802394,0.13593887957403797,0,1,1,1,1,1,0
111,0,91,-111,-20,0.4724853758406316,0.41250949811164567,0.11500512604772307,0.4609256731802969,0.40599119615274293,0.1330831306669603,1,1,1,1,4,1,0
491,365,416,-126,-75,0.4809065608774529,0.4034877975074827,0.1156056416150642,0.42060099971872117,0.4498859268991007,0.12951307338217816,0,1,3,1,1,1,0
302,203,253,-99,-49,0.40639277546350844,0.47764224683140233,0.11596497770508929,0.4311362298961394,0.4402008549610467,0.12866291514281347,1,1,2,1,4,1,0
279,166,232,-113,-47,0.4739362080751263,0.4082268134450217,0.11783697847985176,0.40856447425067227,0.4883487591285051,0.10308676662082265,1,1,1,3,4,1,0
314,273,287,-41,-27,0.45856992393413903,0.4277357844542373,0.11369429161162373,0.4537566430026122,0.41633277228001425,0.1299105847173736,1,1,2,4,4,1,0
263,128,168,-135,-95,0.4367245201251132,0.4503606983666679,0.11291478150821838,0.31433720308129215,0.55541311687726,0.13024968004144752,0,1,1,1,1,1,0
289,132,185,-157,-104,0.519258154771984,0.363632037316066,0.1171098079119499,0.40193425501934144,0.4769299723383583,0.12113577264230017,1,1,1,2,4,1,0
101,106,149,5,48,0.4621256560052157,0.4255228948663583,0.11235144912842612,0.46808954287154425,0.41825578365782157,0.11365467347063389,1,1,1,1,4,0,1
261,195,222,-66,-39,0.4410897422890596,0.44468112706583257,0.11422913064510797,0.42764663408092024,0.46233572530485395,0.11001764061422574,0,1,1,2,1,1,0
339,379,392,40,53,0.40499105918002576,0.4882190394957431,0.10678990132423097,0.4395064952515992,0.4512884330088935,0.10920507173950764,1,1,1,1,4,0,1
280,240,258,-40,-22,0.426581841792891,0.46055633432205684,0.11286182388505209,0.4269096473425092,0.4479891538158576,0.1251011988416333,1,1,1,1,4,1,0
267,169,234,-98,-33,0.4511160996685245,0.43674947480195003,0.1121344255295254,0.4615000145925527,0.4321970162717052,0.10630296913574208,1,1,1,1,4,1,0
364,379,431,15,67,0.4222541751174066,0.4615398004489749,0.11620602443361869,0.459851969436773,0.4084277491555677,0.1317202814076592,1,1,1,1,4,0,1
272,297,348,25,76,0.43780048764203133,0.449330900286691,0.11286861207127762,0.4523365721442382,0.4381854352561907,0.10947799259957096,0,1,4,3,1,0,1
344,303,311,-41,-33,0.4285585289896081,0.4631581524874966,0.10828331852289516,0.33208207645991256,0.5093136359075252,0.15860428763256199,1,1,1,5,4,1,0
356,167,192,-189,-164,0.429419356796889,0.4539681119798716,0.11661253122323952,0.457718299427854,0.42232775525100824,0.11995394532113735,0,1,1,2,1,1,0
325,239,300,-86,-25,0.4454137718079334,0.4397673513329097,0.1148188768591571,0.4710745688615898,0.4173008545975788,0.11162457654083138,1,1,1,1,4,1,0
412,290,364,-122,-48,0.4499392762266087,0.44396838130368654,0.10609234246970471,0.4753596337395685,0.414172016047603,0.11046835021282846,0,1,1,1,1,1,0
136,0,115,-136,-21,0.47935002834473384,0.4044718585506632,0.11617811310460287,0.4449999881010549,0.43288101029644555,0.12211900160249961,0,1,1,1,1,1,0
283,14,227,-269,-56,0.4447960869387069,0.44200887108444425,0.11319504197684871,0.5046185379764574,0.38497618019578195,0.1104052818277609,1,1,1,1,4,1,0
334,202,232,-132,-102,0.4531722649095295,0.43348710869223567,0.11334062639823485,0.3968870272682759,0.4900411344901416,0.11307183824158248,0,1,1,3,1,1,0
347,264,321,-83,-26,0.40850614997026,0.478723208783173,0.11277064124656674,0.40580884388544136,0.4900199580862559,0.10417119802830277,1,1,3,2,4,1,0
308,171,292,-137,-16,0.42359825511154514,0.4609599700316092,0.11544177485684562,0.29530970048410005,0.5889077008023851,0.1157825987135148,0,1,2,1,1,1,0
266,162,190,-104,-76,0.4447960869387069,0.44200887108444425,0.11319504197684871,0.5046185379764574,0.38497618019578195,0.1104052818277609,1,1,1,1,4,1,0
312,150,251,-162,-61,0.4447960869387069,0.44200887108444425,0.11319504197684871,0.5046185379764574,0.38497618019578195,0.1104052818277609,0,1,1,1,1,1,0
385,254,262,-131,-123,0.4533097163391889,0.4314703890069279,0.11521989465388308,0.4352880874067778,0.4329350405187575,0.13177687207446473,1,1,3,2,4,1,0
408,263,339,-145,-69,0.46687540075356804,0.42285781658459665,0.11026678266183516,0.4459190290220604,0.43276077663340196,0.12132019434453784,0,1,1,2,1,1,0
379,290,312,-89,-67,0.4706180720542672,0.4171855627225556,0.11219636522317718,0.421123182744587,0.46383653866505864,0.11504027859035433,0,1,1,1,1,1,0
307,331,352,24,45,0.5199757635820998,0.3637904020455655,0.11623383437233455,0.5829775128702211,0.3144709767132741,0.1025515104165046,1,1,1,1,4,0,1
333,205,226,-128,-107,0.4942815224618504,0.3907768934742568,0.11494158406389289,0.41339147927640696,0.48164583845087594,0.10496268227271706,0,1,1,1,1,1,0
274,185,233,-89,-41,0.4718277759066214,0.4139951773511904,0.11417704674218832,0.34297499665574244,0.5440616037601687,0.11296339958408935,0,1,1,1,1,1,0
469,315,461,-154,-8,0.35868255555948236,0.5332399782288374,0.10807746621168028,0.37436538272747066,0.5023652643196242,0.12326935295290493,0,1,1,2,1,1,0
118,9,24,-109,-94,0.4563268628404587,0.42991279910152175,0.11376033805801952,0.4977392478832101,0.3941793708342533,0.10808138128253629,0,1,1,1,1,1,0
311,185,197,-126,-114,0.4764360350994482,0.4115460601178523,0.1120179047826994,0.46345038069778755,0.42677095283766725,0.10977866646454502,0,1,2,2,1,1,0
138,70,99,-68,-39,0.4366747416514284,0.4503075970676829,0.1130176612808888,0.47533085916924606,0.4104549139262957,0.11421422690445834,1,1,1,1,4,1,0
396,335,348,-61,-48,0.4332949624482301,0.4571647326252289,0.10954030492654122,0.3513883054285509,0.5164036812902129,0.13220801328123613,1,1,2,2,4,1,0
299,51,76,-248,-223,0.4864564130130583,0.3975758390402194,0.1159677479467223,0.4737347405892141,0.40777288350379776,0.1184923759069882,1,1,1,1,4,1,0
290,240,257,-50,-33,0.4507448906818713,0.4329713697948782,0.1162837395232503,0.4466896623380883,0.4313861863453363,0.12192415131657525,0,1,1,2,1,1,0
449,354,399,-95,-50,0.42528953016343013,0.4678754296963989,0.1068350401401708,0.22731171700507094,0.6498531318143006,0.12283515118062854,0,1,2,1,1,1,0
98,60,74,-38,-24,0.4447960869387069,0.44200887108444425,0.11319504197684871,0.5046185379764574,0.38497618019578195,0.1104052818277609,1,1,1,2,4,1,0
360,250,302,-110,-58,0.4075474498898543,0.47759883478035337,0.11485371532979266,0.4364875092652904,0.4599223686417333,0.10359012209297634,0,1,2,1,1,1,0
278,235,270,-43,-8,0.4371224917907922,0.44834372404298795,0.1145337841662201,0.5102153650892638,0.3762883097432343,0.1134963251675019,1,1,1,1,4,1,0
343,252,313,-91,-30,0.46570100522690544,0.4195180799057561,0.11478091486733823,0.3450946635120855,0.5436532719958135,0.11125206449210147,1,1,3,2,4,1,0
382,327,419,-55,37,0.437404740475699,0.4535674481149913,0.1090278114093098,0.3758669686353439,0.48607767322219125,0.1380553581424648,1,1,1,3,4,0,0
272,190,215,-82,-57,0.4532255240047981,0.43238201442000074,0.11439246157520115,0.4779187282643132,0.3889905231940887,0.13309074854159816,0,1,1,4,1,1,0
296,247,258,-49,-38,0.42600604136455,0.4600601035416584,0.11393385509379192,0.4273391351429429,0.4433738261110483,0.1292870387460088,1,1,1,1,4,1,0
15,30,47,15,32,0.4447960869387069,0.44200887108444425,0.11319504197684871,0.5046185379764574,0.38497618019578195,0.1104052818277609,0,1,1,1,1,0,1
80,60,67,-20,-13,0.4447960869387069,0.44200887108444425,0.11319504197684871,0.5046185379764574,0.38497618019578195,0.1104052818277609,1,1,1,2,4,1,0
497,361,438,-136,-59,0.44474359933682694,0.4303263802728075,0.12493002039036508,0.4157294795986646,0.46965516982951905,0.11461535057181635,0,1,2,1,1,1,0
323,299,310,-24,-13,0.48337571985026295,0.4029477736819698,0.11367650646776746,0.49840336297485527,0.4013887248867308,0.1002079121384138,0,1,4,3,1,1,0
216,169,189,-47,-27,0.4427417371016592,0.4432214456381245,0.1140368172602165,0.47287086119734395,0.4235713765260889,0.10355776227656725,1,1,2,3,4,1,0
238,217,249,-21,11,0.48671293259031956,0.4011424366231545,0.11214463078652602,0.39835718027845246,0.4912249494516258,0.11041787026992163,1,1,1,3,4,0,0
378,172,342,-206,-36,0.44083164493870614,0.4495853115931395,0.10958304346815427,0.45903061034792236,0.4335196096112137,0.10744978004086406,0,1,1,2,1,1,0
280,351,397,71,117,0.4977968093157502,0.38589630356559407,0.11630688711865568,0.4731922206644249,0.41337268628223756,0.11343509305333757,1,1,1,2,4,0,1
328,245,290,-83,-38,0.4674513388023167,0.4183172277803093,0.11423143341737406,0.4691704638443547,0.42391436937449445,0.10691516678115096,0,1,1,4,1,1,0
325,269,302,-56,-23,0.4046091496458211,0.4788461246498119,0.11654472570436693,0.41211513901332986,0.4700946662399797,0.11779019474669021,1,1,2,1,4,1,0
303,179,251,-124,-52,0.5186127805325365,0.36639543607038605,0.11499178339707758,0.5515821960755458,0.37069603913433335,0.07772176479012072,0,1,1,1,1,1,0
445,458,517,13,72,0.46088306586385486,0.42476161346455665,0.11435532067158868,0.27893730388404475,0.5893726735326236,0.13169002258333148,1,1,1,1,4,0,1
340,295,309,-45,-31,0.3971872105024873,0.4905068647001391,0.11230592479737402,0.30403927127572533,0.559701208034227,0.1362595206900477,1,1,4,3,4,1,0
258,170,237,-88,-21,0.5363720010395984,0.3447707846141942,0.11885721434620752,0.4459764483265549,0.45567573793056326,0.09834781374288179,0,1,1,1,1,1,0
389,285,298,-104,-91,0.460488878766405,0.42390401293884516,0.11560710829474978,0.22887329454050348,0.6369219089285961,0.1342047965309005,1,1,3,1,4,1,0
188,130,200,-58,12,0.46440687347875337,0.4164650805188226,0.11912804600242405,0.4973764666439613,0.37681942865497425,0.12580410470106418,1,1,1,2,4,0,0
454,317,399,-137,-55,0.5292615857493372,0.35477067877149376,0.1159677354791691,0.46647339211778477,0.3955382695311072,0.13798833835110805,0,1,1,2,1,1,0
259,228,238,-31,-21,0.4411401805710694,0.44651337106057953,0.11234644836835098,0.46160763510293423,0.4264101024577991,0.11198226243926676,0,1,1,1,1,1,0
320,206,312,-114,-8,0.4142013277001865,0.47038569845891026,0.11541297384090335,0.4010303551357001,0.46122344974622925,0.13774619511807043,1,1,1,1,4,1,0
261,136,188,-125,-73,0.4656611224118355,0.4206049065308876,0.11373397105727692,0.5227839562533277,0.3728740253695796,0.10434201837709262,1,1,2,2,4,1,0
298,231,263,-67,-35,0.4571269836940299,0.43140587271287256,0.11146714359309781,0.45757156063446575,0.42709631729313213,0.115332122072402,0,1,1,1,1,1,0
570,408,480,-162,-90,0.5145767975893658,0.3729795996994667,0.11244360271116735,0.5158857996817031,0.3724372350733888,0.11167696524490807,0,1,1,1,1,1,0
120,0,107,-120,-13,0.4686074397810377,0.4168109790718578,0.11458158114710426,0.457081854899981,0.41787603840207754,0.12504210669794164,0,1,1,1,1,1,0
285,211,276,-74,-9,0.449399150402209,0.4373946857083871,0.11320616388940404,0.4941500675262654,0.3976794513534076,0.10817048112032697,1,1,1,1,4,1,0
318,193,230,-125,-88,0.445437494648539,0.446783697357769,0.10777880799369191,0.444906454905296,0.4381286641444617,0.1169648809502425,1,1,1,1,4,1,0
267,235,246,-32,-21,0.4318622289817225,0.4469488371006393,0.12118893391763833,0.34416376667041365,0.5071517975747563,0.14868443575482998,0,1,1,1,1,1,0
284,216,253,-68,-31,0.4540366540401339,0.43042257088791935,0.11554077507194664,0.4029602105207726,0.49409046432051584,0.10294932515871143,1,1,2,1,4,1,0
247,176,230,-71,-17,0.41247651452080875,0.47639239612283235,0.11113108935635901,0.38787263838991065,0.49795843370271436,0.11416892790737455,0,1,1,1,1,1,0
251,184,201,-67,-50,0.44800732996818593,0.43802861599430537,0.11396405403750887,0.47576688706826825,0.41667416652180334,0.10755894640992855,1,1,2,2,4,1,0
18,37,101,19,83,0.4447960869387069,0.44200887108444425,0.11319504197684871,0.5046185379764574,0.38497618019578195,0.1104052818277609,1,1,1,2,4,0,1
81,31,54,-50,-27,0.43069892084649136,0.456434117144067,0.11286696200944189,0.4875700383593369,0.39177584106213464,0.12065412057852833,1,1,1,1,4,1,0
414,355,370,-59,-44,0.47197275620505463,0.41648174061606885,0.11154550317887649,0.42931301709738157,0.450942411410549,0.11974457149206945,1,1,2,1,4,1,0
301,264,277,-37,-24,0.42530733386257363,0.46143476692563656,0.11325789921178953,0.387067038763031,0.4893849933527177,0.12354796788425118,1,1,2,2,4,1,0
318,101,128,-217,-190,0.44703915685084883,0.4403609676591496,0.11259987549000126,0.4956815055101044,0.3969032950805634,0.10741519940933193,0,1,1,2,1,1,0
316,343,372,27,56,0.422694880893953,0.4590541402053553,0.11825097890069176,0.26348500154703164,0.6105587113365518,0.12595628711641638,1,1,2,2,4,0,1
407,363,384,-44,-23,0.43387679875331525,0.45001270766687795,0.11611049357980688,0.4316869461305319,0.436146711333578,0.13216634253589005,1,1,1,1,4,1,0
212,131,147,-81,-65,0.4388355545745366,0.44479466514472454,0.11636978028073894,0.4766383910196457,0.4043226255672836,0.11903898341307087,1,1,1,1,4,1,0
433,255,328,-178,-105,0.43588907948235867,0.4465807196911643,0.11753020082647708,0.43677253311257835,0.47241059777805716,0.09081686910936469,1,1,2,3,4,1,0
246,111,215,-135,-31,0.4419000741112187,0.44620680900542403,0.11189311688335735,0.3972533267365219,0.49613217410884075,0.10661449915463724,1,1,1,1,4,1,0
348,259,266,-89,-82,0.48937256722364286,0.39418460413735873,0.11644282863899813,0.5199197747422046,0.36832317359080025,0.11175705166699504,0,1,1,1,1,1,0
284,145,208,-139,-76,0.5077626473097332,0.3747938610799007,0.11744349161036637,0.44136092003883887,0.4461296932363973,0.1125093867247636,0,1,1,1,1,1,0
373,293,347,-80,-26,0.38191897210403747,0.4996551429642475,0.11842588493171499,0.3366136544285148,0.5217515805024533,0.14163476506903183,1,1,1,4,4,1,0
